βαλεαρίδες νήσοι - [balearides nisi]
βαλτική θάλασσα - [baltiki zalasa]
βανκούβερ - [bankuber]
βαντούζ - [badus]
βαρσοβία - [barsobia]
βαστίλη - [bastili]
βελιγράδι - [beligradi]
βενεζουέλα - [benesuela]
βερμούδες - [bermudes]
βερολίνο - [berolino]
βερσαλλίες - [bersalies]
βηθλεέμ - [bizleem]
βιέννη - [bieni]
βιετνάμ - [bietnam]
βικιλεξικό - [bikileksiko]
βικιπαίδεια - [bikipedia]
βιτρούβιος - [bitrubios]
βολιβία - [bolibia]
βολιβιανός - [bolibianos]
βολταίρος - [bolteros]
βοσνία και ερζεγοβίνη - [bosnia ke ersegobini]
βουδαπέστη - [budapesti]
βουκουρέστι - [bukuresti]
βουλγαρία - [bulgaria]
βούλγαρος - [bulgaros]
βούληση - [bulisi]
βραζιλία - [brasilia]
βραζιλιάνος - [brasilianos]
βρετανικά νησιά - [bretanika nisia]
βρετανικές παρθένες νήσοι - [bretanikes parzenes nisi]
βρετανο-ινδική ωκεανική έκταση - [bretano-indiki okeaniki ektasi]
βρυξέλλες - [brikseles]
βόλγας - [bolgas]
βόλτος - [boltos]
βόννη - [boni]
βόρεια αμερική - [boria ameriki]
βόρεια ευρώπη - [boria efropi]
βόρεια θάλασσα - [boria zalasa]
βόρεια ιρλανδία - [boria irlandia]
βόρεια κορέα - [boria korea]
βόρεια ρηνανία-βεστφαλία - [boria rinania-bestfalia]
βόρειες μαριάνα - [bories mariana]
βόρειος ατλαντικός ωκεανός - [borios atladikos okeanos]
βόρειος αφρική - [borios afriki]
βόρειος ειρηνικός ωκεανός - [borios irinikos okeanos]
γπδ - [gpd]
γάλλοι - [gali]
γίντις - [gidis]
γαλαξίας - [galaksias]
γαλατία - [galatia]
γαλλία - [galia]
γαλλίδα - [galida]
γαλλικά - [galika]
γαλλικά νότια και ανταρκτικά εδάφη - [galika notia ke adarktika edafi]
γαλλική γουιάνα - [galiki guiana]
γαλλική επανάσταση - [galiki epanastasi]
γαλλική πολυνησία - [galiki polinisia]
γανυμήδης - [ganimidis]
γερμανία - [germania]
γερμανίδα - [germanida]
γερμανός - [germanos]
γεωργία - [georgia]
γη - [gi]
γιαπωνέζος - [giaponesos]
γιβραλτάρ - [gibraltar]
γιερεβάν - [giereban]
γιουγκοσλαβία - [giugkoslabia]
γκάμπια - [gkabia]
γκάνα - [gkana]
γκέρνσεϊ - [gkernsi]
γκαμπόν - [gkabon]
γκανέζος - [gkanesos]
γκουάμ - [gkuam]
γκρόζνυ - [gkrosni]
γλαγολιτικό αλφάβητο - [glagolitiko alfabito]
γονιδιωματική - [gonidiomatiki]
γουαδελούπη - [guadelupi]
γουατεμάλα - [guatemala]
γουιάνα - [guiana]
γουινέα - [guinea]
γουινέα-μπισσάου - [guinea-bisau]
γραμμική α - [gramiki a]
γρενάδα - [grenada]
γροιλανδία - [grilandia]
δαμασκός - [damaskos]
δανία - [dania]
δεκέμβριος - [dekembrios]
δελχί - [delji]
δευτέρα - [deftera]
δημοκρατία της ινγκουσετίας - [dimokratia tis ingkusetias]
δημοκρατία της καλμίκια - [dimokratia tis kalmikia]
δημοκρατία της καμπαρντίνο - μπαλκάρια - [dimokratia tis kabardino - balkaria]
δημοκρατία της μαρίι ελ - [dimokratia tis mari el]
δημοκρατία της μπουργιατίας - [dimokratia tis burgiatias]
δημοκρατία της τιβά - [dimokratia tis tiba]
δημοκρατία της χακασίας - [dimokratia tis jakasias]
δημοκρατία του κογνκό - [dimokratia tu kognko]
δημοκρατία του μπασκορτοστάν - [dimokratia tu baskortostan]
δημοκρατία των αλτάι - [dimokratia ton alte]
δημοκρατία των καρατσάι - τσερκεσίων - [dimokratia ton karatse - tserkesion]
δημοκρατία των κόμι - [dimokratia ton komi]
δημοκρατία των ουντμούρτ - [dimokratia ton udmurt]
δημοκρατία των σαχά - [dimokratia ton saja]
δημοτική επιχείριση καθαριότητας - [dimotiki epijirisi kazariotitas]
διαδίκτυο - [diadiktio]
διεθνές δικαστήριο - [dieznes dikastirio]
διεθνές νομισματικό ταμείο - [dieznes nomismatiko tamio]
διεθνούς οργανισμού τυποποίησης - [dieznus organismu tipopiisis]
διθύραμβος - [dizirambos]
δικαιώματα της φύσης - [dikeomata tis fisis]
διώνη - [dioni]
δομινικανή δημοκρατία - [dominikani dimokratia]
δουβλίνο - [dublino]
δυτική ασία - [ditiki asia]
δυτική αφρική - [ditiki afriki]
δυτική ευρώπη - [ditiki efropi]
ε.κ.τ. - [e.k.t.]
εγκέλαδος - [egkelados]
εδιμβούργο - [edimburgo]
ειρηνικός ωκεανός - [irinikos okeanos]
ελ νίνιο - [el ninio]
ελ σαλβαδόρ - [el salbador]
ελβετία - [elbetia]
ελλάδα - [elada]
ελλάς - [elas]
εξτρεμαδούρα - [ekstremadura]
εποχή του λίθου - [epoji tu lizu]
ερμής - [ermis]
ερυθρά θάλασσα - [erizra zalasa]
ερυθραία - [erizrea]
εσθονία - [eszonia]
ευαγγέλιο - [efagelio]
ευρασια - [efrasia]
ευρατόμ - [efratom]
ευρωζώνη - [efrosoni]
ευρωπαϊκές κοινότητες - [efropekes kinotites]
ευρωπαϊκή ένωση - [efropeki enosi]
ευρωπαϊκή επιτροπή - [efropeki epitropi]
ευρωπαϊκή κεντρική τράπεζα - [efropeki kedriki trapesa]
ευρωπαϊκό κοινοβούλιο - [efropeko kinobulio]
ευρωπαϊκό νομισματικό σύστημα - [efropeko nomismatiko sistima]
ευρωπαϊκό περιβαλλοντικό συμβούλιο - [efropeko peribalodiko simbulio]
ευρωπαϊκός οργανισμός περιβάλλοντος - [efropekos organismos peribalodos]
ευρώπη - [efropi]
ζάγκρεμπ - [sagkreb]
ζάμπια - [sabia]
ζιμπάμπουε - [sibabue]
ζυθοποιία - [sizopiia]
η φύση έκανε για κάθε ζώο τον εχθρό του - [i fisi ekane gia kaze soo ton ejzro tu]
η.π.α. - [i.p.a.]
ηνωμένα έθνη - [inomena ezni]
ηνωμένα αραβικά εμιράτα - [inomena arabika emirata]
ηνωμένες πολιτείες - [inomenes polities]
ηνωμένες πολιτείες της αμερικής - [inomenes polities tis amerikis]
ηνωμένο βασίλειο - [inomeno basilio]
ηνωμένο βασίλειο της μεγάλης βρετανίας και της βορείου ιρλανδίας - [inomeno basilio tis megalis bretanias ke tis boriu irlandias]
θάλασσα του μαρμαρά - [zalasa tu marmara]
θάλασσα του οχότσκ - [zalasa tu ojotsk]
θάνατος - [zanatos]
θαλάσσια ακτή - [zalasia akti]
θεοφάνια - [zeofania]
θεωρία της σχετικότητας - [zeoria tis sjetikotitas]
θεός - [zeos]
θουριγγία - [zurigia]
ιάπωνας - [iaponas]
ιανουάριος - [ianuarios]
ιαπωνία - [iaponia]
ικάριο πέλαγος - [ikario pelagos]
ιλιάδα - [iliada]
ιμπρεσιονισμός - [ibresionismos]
ινδία - [india]
ινδθκός ωκεανός - [indzkos okeanos]
ινδονησία - [indonisia]
ιντεφίξ - [idefiks]
ιντιάνα - [idiana]
ιορδανία - [iordania]
ιουδαία - [iudea]
ιουδαϊσμός - [iudesmos]
ιούλιος - [iulios]
ιράκ - [irak]
ιράν - [iran]
ιρίδιο - [iridio]
ιρακινός - [irakinos]
ιρλανδία - [irlandia]
ισημερινή γουινέα - [isimerini guinea]
ισημερινός - [isimerinos]
ισλάμ - [islam]
ισλαμαμπάντ - [islamabad]
ισλανδία - [islandia]
ισλανδός - [islandos]
ισπανία - [ispania]
ισραήλ - [israil]
ιταλία - [italia]
ιόνιο πέλαγος - [ionio pelagos]
κάιρο - [kero]
κάτω βουλή - [kato buli]
κάτω σαξωνία - [kato saksonia]
κάτω χώρες - [kato jores]
κέηπ τάουν - [keip taun]
κένυα - [kenia]
κέρες - [keres]
κέρκυρα - [kerkira]
κίεβο - [kiebo]
κίνα - [kina]
καίσαρας - [kesaras]
καζαχστάν - [kasajstan]
κακοφωνίξ - [kakofoniks]
καλά χριστούγεννα - [kala jristugena]
καλιφόρνια - [kalifornia]
καλυψώ - [kalipso]
καμερουνέζος - [kamerunesos]
καμερούν - [kamerun]
καμπέρα - [kabera]
καμπότζη - [kabotsi]
καναδάς - [kanadas]
καπιταλισμός - [kapitalismos]
καραϊβική θάλασσα - [karebiki zalasa]
καρκίνος - [karkinos]
κασμίρ - [kasmir]
κασπία θάλασσα - [kaspia zalasa]
κατάληψη - [katalipsi]
κατάρ - [katar]
καταλφαβητίξ - [katalfabitiks]
κατμαντού - [katmadu]
κατοβίτσε - [katobitse]
κελσίου - [kelsiu]
κεντρική αμερική - [kedriki ameriki]
κεντρική ασία - [kedriki asia]
κεντρική αφρική - [kedriki afriki]
κεντροαφρικανική δημοκρατία - [kedroafrikaniki dimokratia]
κεράτιος κόλπος - [keratios kolpos]
κινέζος - [kinesos]
κιργιζία - [kirgisia]
κιριμπάτι - [kiribati]
κιριτιμάτι - [kiritimati]
κισινάου - [kisinau]
κιότο - [kioto]
κνεσέτ - [kneset]
κοινοβούλιο - [kinobulio]
κολομβία - [kolombia]
κομόρες - [komores]
κοπεγχάγη - [kopegjagi]
κοράνιο - [koranio]
κορνουάλλη - [kornuali]
κουάλα λουμπούρ - [kuala lubur]
κουβέιτ - [kubit]
κουβανή - [kubani]
κουβανός - [kubanos]
κούβα - [kuba]
κράι αλτάι - [kre alte]
κράτος της πόλης του βατικανού - [kratos tis polis tu batikanu]
κρήτη - [kriti]
κριμαϊκή ταταρική γλώσσα - [krimeki tatariki glosa]
κριός - [krios]
κροατία - [kroatia]
κρόνος - [kronos]
κυρηναϊκή - [kirineki]
κυριακή - [kiriaki]
κωνσταντινούπολις - [konstadinupolis]
κως - [kos]
κόστα ρίκα - [kosta rika]
κύθηρα - [kizira]
κύμη - [kimi]
κύπρια - [kipria]
κύπριος - [kiprios]
κύπρος - [kipros]
λάος - [laos]
λέων - [leon]
λίβανος - [libanos]
λίρα - [lira]
λα - [la]
λατινική αυτοκρατορία - [latiniki aftokratoria]
λαϊκή δημοκρατία της αλγερίας - [leki dimokratia tis algerias]
λαϊκή δημοκρατία της γερμανίας - [leki dimokratia tis germanias]
λαϊκή δημοκρατία του κονγκό - [leki dimokratia tu kongko]
λεσόθο - [lesozo]
λεττονία - [letonia]
λευκορωσία - [lefkorosia]
λευκορωσίδα - [lefkorosida]
λευκορώσα - [lefkorosa]
λευκορώσος - [lefkorosos]
λιέγη - [liegi]
λιβερία - [liberia]
λιβύη - [libii]
λιθουανία - [lizuania]
λιουμπλιάνα - [liubliana]
λιούι - [liui]
λισσαβώνα - [lisabona]
λιχτενστάιν - [lijtensten]
λομέ - [lome]
λονδίνο - [londino]
λος άντζελες - [los adseles]
λουξεμβούργο - [luksemburgo]
λυδία - [lidia]
λωζάνη - [losani]
μάης - [mais]
μάιντς - [meds]
μάιος - [meos]
μάλι - [mali]
μάλτα - [malta]
μάντσεστερ - [madsester]
μάρτιος - [martios]
μέλας δρυμός - [melas drimos]
μέση ανατολή - [mesi anatoli]
μαγιότ - [magiot]
μαδέρα - [madera]
μαδαγασκάρη - [madagaskari]
μαδρίτη - [madriti]
μαζεστίξ - [masestiks]
μαθουσαλίξ - [mazusaliks]
μακάου - [makau]
μακεδονία - [makedonia]
μαλάουι - [malaui]
μαλαισία - [malesia]
μαλδίβες - [maldibes]
μανάμα - [manama]
μαρξισμός - [marksismos]
μαρτινίκα - [martinika]
μαρόκο - [maroko]
μασσαλία - [masalia]
μαυρίκιος - [mafrikios]
μαυριτανία - [mafritania]
μαυροβούνιο - [mafrobunio]
μαύρη θάλασσα - [mafri zalasa]
μεγάλη άρκτος - [megali arktos]
μεγάλο σάββατο - [megalo sabbato]
μεξικό - [meksiko]
μεροβίγγειοι - [merobigii]
μεσόγειος θάλασσα - [mesogios zalasa]
μι - [mi]
μικρά ασία - [mikra asia]
μικρές απόμακροι νήσοι ηνωμένων πλιτειών - [mikres apomakri nisi inomenon plition]
μικρονησία - [mikronisia]
μιλάνο - [milano]
μιμίνα - [mimina]
μινσκ - [minsk]
μογγολία - [mogolia]
μοζαμβίκη - [mosambiki]
μολδαβία - [moldabia]
μονακό - [monako]
μοντσερράτ - [modserat]
μπάτμαν - [batman]
μπέρμιγχαμ - [bermigjam]
μπαγγλαντές - [baglades]
μπαγγόκ - [bagok]
μπαγκόκ - [bagkok]
μπακού - [baku]
μπανγκόκ - [bangkok]
μπανκόκ - [bankok]
μπαντάρ σερί μπεγκαβάν - [badar seri begkaban]
μπαρμπάντος - [barbados]
μπαχάμες - [bajames]
μπαχρέιν - [bajrin]
μπελίζε - [belise]
μπενίν - [benin]
μπεφάνα - [befana]
μπλε τζαμί - [ble tsami]
μπογιακά - [bogiaka]
μπονεμίνα - [bonemina]
μποτσουάνα - [botsuana]
μπουβέ - [bube]
μπουρκίνα φάσο - [burkina faso]
μπουρούντι - [burudi]
μπουτάν - [butan]
μπρατισλάβα - [bratislaba]
μπρουνέι - [bruni]
μυανμάρ - [mianmar]
μόναχο - [monajo]
μόντρεαλ - [modreal]
μόσχα - [mosja]
νέα αγγλία - [nea aglia]
νέα ζηλανδία - [nea silandia]
νέα καληδονία - [nea kalidonia]
νέα υόρκη - [nea iorki]
νήσοι κουκ - [nisi kuk]
νήσοι μάρσαλ - [nisi marsal]
νήσοι σολομώντος - [nisi solomodos]
νήσοι φάλκλαντ - [nisi falklad]
νήσοι φερόες - [nisi feroes]
νήσος μαν - [nisos man]
νίγηρας - [nigiras]
ναβάρρα - [nabara]
ναζί - [nasi]
ναμίμπια - [namibia]
ναουρού - [nauru]
νεολιθική επανάσταση - [neoliziki epanastasi]
νεπάλ - [nepal]
νεπτούνους - [neptunus]
νησί των χριστουγέννων - [nisi ton jristugenon]
νησιά άλαντ - [nisia alad]
νησιά καϋμάν - [nisia kafman]
νησιά πίτκαιρν - [nisia pitkern]
νησιά τουρκ και κάικος - [nisia turk ke kekos]
νιγηρία - [nigiria]
νικαράγουα - [nikaragua]
νιούε - [niue]
νοέμβρης - [noembris]
νοέμβριος - [noembrios]
νορβηγία - [norbigia]
νοτιο-ανατολική ασία - [notio-anatoliki asia]
νουακσότ - [nuaksot]
ντάλας - [dalas]
ντίσελντορφ - [diseldorf]
ντιούι - [diui]
ντο - [do]
ντομίνικα - [dominika]
ντον - [don]
ντουάλα - [duala]
ντόχα - [doja]
νυρεμβέργη - [nirembergi]
νότια αφρική - [notia afriki]
νότια κορέα - [notia korea]
νότιος αμερική - [notios ameriki]
νότιος ασία - [notios asia]
νότιος ατλαντικός ωκεανός - [notios atladikos okeanos]
νότιος αφρική - [notios afriki]
νότιος ειρηνικός ωκεανός - [notios irinikos okeanos]
ο πόλεμος των άστρων - [o polemos ton astron]
οβελίξ - [obeliks]
ογκώδη απορρίμματα - [ogkodi aporimata]
ολλανδία - [olandia]
ολλανδικές αντίλλες - [olandikes adiles]
ολλανδός - [olandos]
ολυμπιακοί αγώνες - [olibiaki agones]
ομάν - [oman]
ονδούρα - [ondura]
οξιτανική - [oksitaniki]
οξφόρδη - [oksfordi]
οργανισμός - [organismos]
ουάσινγκτον - [uasingkton]
ουέλλινγκτον - [uelingkton]
ουαγκαντουγκού - [uagkadugku]
ουγγαρία - [ugaria]
ουγκάντα - [ugkada]
ουζμπεκιστάν - [usbekistan]
ουκρανία - [ukrania]
ουντμουρτία - [udmurtia]
ουρανός - [uranos]
ουρουγουάη - [uruguai]
ουώλλις και φουτούνα - [uolis ke futuna]
οχοτσκική θάλασσα - [ojotskiki zalasa]
ούγγρος - [ugros]
πάλλιον - [palion]
πάσχα - [pasja]
πέμπτη - [pebti]
πέστο - [pesto]
παγγαία - [pagea]
παγκόσμιος ιστός - [pagkosmios istos]
πακιστάν - [pakistan]
παλάου - [palau]
παλαιοζωική εποχή - [paleosoiki epoji]
παλαιστίνη - [palestini]
παναγία - [panagia]
παναμάς - [panamas]
παννονία - [panonia]
πανοραμίξ - [panoramiks]
παπουασία-νέα γουινέα - [papuasia-nea guinea]
παρίσι - [parisi]
παραγουάη - [paraguai]
παρασκευή - [paraskefi]
παρθένος - [parzenos]
πεκίνο - [pekino]
πελοπόννησος - [peloponisos]
πεντηκοστή - [pedikosti]
περιοδικός πίνακας των χημικών στοιχείων - [periodikos pinakas ton jimikon stijion]
περού - [peru]
περπινιάν - [perpinian]
περσικός κόλπος - [persikos kolpos]
πιεντμοντέζικα - [piedmodesika]
πιτσιλέμου - [pitsilemu]
πιχιλήμu - [pijilimu]
πλούτωνας - [plutonas]
πολιτεία νέας υόρκης - [politia neas iorkis]
πολωνία - [polonia]
πορτογαλία - [portogalia]
ποσειδώνας - [posidonas]
ποτσουόλι - [potsuoli]
πουέρτο ρίκο - [puerto riko]
πράγα - [praga]
πράσινο ακρωτήριο - [prasino akrotirio]
πριγκηπάτο του λιχτενστάιν - [prigkipato tu lijtensten]
προμηθέας - [promizeas]
πρωσία - [prosia]
πρωτογλώσσα - [protoglosa]
πρωτοχρονιά - [protojronia]
πόλη νέας υόρκης - [poli neas iorkis]
πόλη του μεξικού - [poli tu meksiku]
πόρτο - [porto]
πύργος του άιφελ - [pirgos tu efel]
πύρρειος νίκη - [pirios niki]
ρέτζο νελλ’εμίλια - [retso nelemilia]
ρέυκιαβικ - [refkiabik]
ρήνος - [rinos]
ρίγα - [riga]
ρε - [re]
ρεσίφε - [resife]
ρεϊνιόν - [rinion]
ρουάντα - [ruada]
ρουβίκωνας - [rubikonas]
ρουμανία - [rumania]
ρωσία - [rosia]
ρώμη - [romi]
ρώσος - [rosos]
σεαα - [seaa]
σάββατο - [sabbato]
σάο πάολο - [sao paolo]
σάο τομέ και πρίνσιπε - [sao tome ke prinsipe]
σάρλοτ - [sarlot]
σαιν πιέρ ε μικελόν - [sen pier e mikelon]
σαμόα - [samoa]
σαν μιγκέλ ντε τουκουμάν - [san migkel de tukuman]
σαξωνία - [saksonia]
σαουδική αραβία - [saudiki arabia]
σαραγόσα - [saragosa]
σαχέλ - [sajel]
σενεγάλη - [senegali]
σεούλ - [seul]
σεπτέμβριος - [septembrios]
σερβία - [serbia]
σερβία και μαυροβούνιο - [serbia ke mafrobunio]
σερβικά - [serbika]
σεϋχέλλες - [sefjeles]
σηκουάνας - [sikuanas]
σι - [si]
σιέρρα λεόνε - [siera leone]
σιγκαπούρη - [sigkapuri]
σιουδάδ μπολίβαρ - [siudad bolibar]
σκρουτζ μακ ντακ - [skruts mak dak]
σκωτία - [skotia]
σκόπια - [skopia]
σλέσβιχ-χολστάιν - [slesbij-jolsten]
σλοβένος - [slobenos]
σλοβακία - [slobakia]
σλοβακικά - [slobakika]
σλοβενία - [slobenia]
σμύρνη - [smirni]
σολ - [sol]
σομαλία - [somalia]
σουαζιλάνδη - [suasilandi]
σουδάν - [sudan]
σουηδία - [suidia]
σουρινάμ - [surinam]
σρι λάνκα - [sri lanka]
σταχτοπούτα - [stajtoputa]
στερεομεταφορά - [stereometafora]
συλτ - [silt]
συμβούλιο υπουργών της εκ - [simbulio ipurgon tis ek]
συμβούλιο της εε - [simbulio tis ee]
συνμετ - [sinmet]
συρία - [siria]
σότσι - [sotsi]
σόφια - [sofia]
τέξας - [teksas]
τίβερης - [tiberis]
τίβερις - [tiberis]
τίρανα - [tirana]
τανζανία - [tansania]
ταοϊσμός - [taismos]
ταρραγόνα - [taragona]
τασκένδη - [taskendi]
τατζικιστάν - [tatsikistan]
ταϊβάν - [teban]
ταϊλάνδη - [telandi]
τελ αβίβ - [tel abib]
τεννεσσή - [tenesi]
τετάρτη - [tetarti]
τεχεράνη - [tejerani]
τζένγκις χαν - [tsengkis jan]
τζέρσεϋ - [tsersef]
τζακάρτα - [tsakarta]
τζαμάικα - [tsameka]
τζιμπουτί - [tsibuti]
τοκελάου - [tokelau]
τοπ καπί - [top kapi]
τορόντο - [torodo]
τουβαλού - [tubalu]
τουρκία - [turkia]
τουρκική λίρα - [turkiki lira]
τουρκμενιστάν - [turkmenistan]
τρίτη - [triti]
τρινιδάδ και τομπάγκο - [trinidad ke tobagko]
τσαντ - [tsad]
τσεχία - [tsejia]
τσεχοσλοβακία - [tsejoslobakia]
τσιτά - [tsita]
τυνησία - [tinisia]
τυφώνας - [tifonas]
τόγκο - [togko]
τόκιο - [tokio]
τόκυο - [tokio]
τόνγκα - [tongka]
τύνιδα - [tinida]
υεμένη - [iemeni]
υποκατάσταση - [ipokatastasi]
φέρμιο - [fermio]
φίλτρο - [filtro]
φίτζι - [fitsi]
φα - [fa]
φεβρουάριος - [februarios]
φιλαδέλφεια - [filadelfia]
φιλιππίνες - [filipines]
φινλανδία - [finlandia]
φινλανδός - [finlandos]
φλέβολαντ - [flebolad]
φλεβάρης - [flebaris]
φοβος - [fobos]
φράγκιο - [fragkio]
φραγκφούρτη - [fragkfurti]
φριζιακά - [frisiaka]
φυτώριο - [fitorio]
φωνητική - [fonitiki]
φωτογραφική μηχανή - [fotografiki mijani]
χάγη - [jagi]
χάμιλτον - [jamilton]
χίμαιρα - [jimera]
χαβάη - [jabai]
χαβανέζικα - [jabanesika]
χαλέπι - [jalepi]
χαρούμενα γενέθλια - [jarumena genezlia]
χιλή - [jili]
χιλιανός - [jilianos]
χιούι - [jiui]
χονγκ κονγκ - [jongk kongk]
χριστούγεννα - [jristugena]
χριστόφορος - [jristoforos]
ωκεανία - [okeania]
ωμέγα - [omega]
άβακας - [abakas]
άγαλμα - [agalma]
άγγελος - [agelos]
άγκιστρο - [agkistro]
άγκυρα - [agkira]
άγονος - [agonos]
άγριο ζώο - [agrio soo]
άγριο φυτό - [agrio fito]
άδεια - [adia]
άδεια αλιείας - [adia aliias]
άδεια εισαγωγής - [adia isagogis]
άδεια κυνηγίου - [adia kinigiu]
άδεια οδήγησης - [adia odigisis]
άδης - [adis]
άζωτο - [asoto]
άθεος - [azeos]
άθλημα - [azlima]
άθληση - [azlisi]
άιντε - [ede]
άκερκα - [akerka]
άκρο - [akro]
άλατα - [alata]
άλγεβρα - [algebra]
άλγος - [algos]
άλεση - [alesi]
άλκη - [alki]
άλογο - [alogo]
άλογο κούρσας - [alogo kursas]
άμβωνας - [ambonas]
άμεση πηγή εκπομπών - [amesi pigi ekpobon]
άμμος - [amos]
άμοιρος - [amiros]
άμυλο - [amilo]
άμυνα - [amina]
άνεμος - [anemos]
άνεργος - [anergos]
άνηθος - [anizos]
άνθος - [anzos]
άνθρακας - [anzrakas]
άνθρωπος - [anzropos]
άνοια - [ania]
άνοιξη - [aniksi]
άνουρα - [anura]
άντε - [ade]
άντρας - [adras]
άνυσμα - [anisma]
άνω γνάθος - [ano gnazos]
άξονας - [aksonas]
άπορος - [aporos]
άργιλος - [argilos]
άργυρος - [argiros]
άρδευση - [ardefsi]
άρδευση στάγδην - [ardefsi stagdin]
άρθρο - [arzro]
άρθρωση - [arzrosi]
άροτρο - [arotro]
άρρητος - [aritos]
άρρωστος - [arostos]
άρτιος - [artios]
άσβεστος - [asbestos]
άσθμα - [aszma]
άσπρο - [aspro]
άσπρος - [aspros]
άστατο - [astato]
άστεγος - [astegos]
άσφαλτος - [asfaltos]
άσχημος - [asjimos]
άτλας - [atlas]
άτομο - [atomo]
άτομον - [atomon]
άχρηστα ηλεκτρονικά υλικά - [ajrista ilektronika ilika]
άχρηστο μέταλλο - [ajristo metalo]
άχρηστο υλικό - [ajristo iliko]
άχρηστο όχημα - [ajristo ojima]
άψογος - [apsogos]
έγγειος φόρος - [egios foros]
έγγραφο - [egrafo]
έγκλημα - [egklima]
έγκλημα κατά του περιβάλλοντος - [egklima kata tu peribalodos]
έγκριση - [egkrisi]
έγκυος - [egkios]
έγκυρος - [egkiros]
έδαφος - [edafos]
έδαφος οριακής απόδοσης - [edafos oriakis apodosis]
έιτζ - [its]
έκδοση πιστοποιητικού ποιότητας - [ekdosi pistopiitiku piotitas]
έκθεση - [ekzesi]
έκθεση σε ακτινοβολία - [ekzesi se aktinobolia]
έκπληξη - [ekpliksi]
έκπλυση - [ekplisi]
έκρηξη - [ekriksi]
έκσταση - [ekstasi]
έκταση - [ektasi]
έκτροπο - [ektropo]
έκφραση - [ekfrasi]
έλατο - [elato]
έλατος - [elatos]
έλαφος - [elafos]
έλεγχος - [elegjos]
έλεγχος οχημάτων - [elegjos ojimaton]
έλεγχος ποιότητας - [elegjos piotitas]
έλεγχος της ποιότητας του αέρα - [elegjos tis piotitas tu aera]
έλεγχος των γεννήσεων - [elegjos ton geniseon]
έλεγχος των οχλήσεων - [elegjos ton ojliseon]
έλκω - [elko]
έλος - [elos]
έλος μανγκρόβιας - [elos mangkrobias]
έμβρυο - [embrio]
έμεσμα - [emesma]
έμπειρο σύστημα - [ebiro sistima]
ένα - [ena]
έναρξη - [enarksi]
ένας - [enas]
ένας τουρίστας - [enas turistas]
ένατος - [enatos]
έναυση - [enafsi]
ένδεια - [endia]
ένδικο μέσο - [endiko meso]
ένδυση - [endisi]
ένεση - [enesi]
ένζυμο - [ensimo]
έννοια - [enia]
ένοπλες δυνάμεις - [enoples dinamis]
ένοχος - [enojos]
ένσταση - [enstasi]
ένταλμα - [edalma]
ένταση ήχου - [edasi iju]
ένταση του θορύβου - [edasi tu zoribu]
έντεκα - [edeka]
έντερα - [edera]
έντομα - [edoma]
έντυπο υλικό - [edipo iliko]
ένωση μολύβδου - [enosi molibdu]
έξαρση φυκοπλαγκτού - [eksarsi fikoplagktu]
έξοδος - [eksodos]
έξοδος κινδύνου - [eksodos kindinu]
έπιπλα - [epipla]
έπος - [epos]
έρβιο - [erbio]
έρευνα - [erefna]
έρευνα αγοράς - [erefna agoras]
έρευνα του διαστήματος - [erefna tu diastimatos]
έρημος - [erimos]
έριο - [erio]
έρχομαι - [erjome]
έφεση - [efesi]
έφηβη - [efibi]
έφηβος - [efibos]
ήδη - [idi]
ήθη - [izi]
ήλιο - [ilio]
ήλιος - [ilios]
ήμαρτον - [imarton]
ήπειρος - [ipiros]
ήρεμη - [iremi]
ήρεμος - [iremos]
ήχος - [ijos]
ίζημα - [isima]
ίνδιο - [indio]
ίουλος - [iulos]
ίππος - [ipos]
ίρις - [iris]
ίσια - [isia]
αέρας - [aeras]
αέρας αναπνοής - [aeras anapnois]
αέρας εδάφους - [aeras edafus]
αέρια κατάσταση - [aeria katastasi]
αέριο - [aerio]
αέριο του θερμοκηπίου - [aerio tu zermokipiu]
αέριος ρύπος - [aerios ripos]
αίθουσα - [ezusa]
αίθουσα αναμονής - [ezusa anamonis]
αίθουσα χορού - [ezusa joru]
αίμα - [ema]
αίτηση - [etisi]
ααβόρα - [aabora]
αβάν-γκαρντ - [aban-gkard]
αβάσιμος - [abasimos]
αβγό - [abgo]
αβιοτικός παράγοντας - [abiotikos paragodas]
αβοκάντο - [abokado]
αβχαζιανά - [abjasiana]
αγάπη - [agapi]
αγάπη για τη φύση - [agapi gia ti fisi]
αγέννητος - [agenitos]
αγαθά - [agaza]
αγαθά και υπηρεσίες - [agaza ke ipiresies]
αγαμία - [agamia]
αγαπώ - [agapo]
αγγειεκτομή - [agiektomi]
αγγειοδιασταλτικό - [agiodiastaltiko]
αγγειοδιαστολή - [agiodiastoli]
αγγειοπλαστική - [agioplastiki]
αγγειόσπερμα - [agiosperma]
αγγελιοφόρος - [agelioforos]
αγγελτήριο - [ageltirio]
αγγλικά - [aglika]
αγγούρι - [aguri]
αγελάδα - [agelada]
αγιογραφία - [agiografia]
αγκάθι - [agkazi]
αγκώνας - [agkonas]
αγνωστικιστής - [agnostikistis]
αγνώμων - [agnomon]
αγορά - [agora]
αγορά ενέργειας - [agora energias]
αγορά εργασίας - [agora ergasias]
αγορά παραγόντων - [agora paragodon]
αγοράζω - [agoraso]
αγοραία τιμή - [agorea timi]
αγοραστική - [agorastiki]
αγοραφοβία - [agorafobia]
αγριογούρουνο - [agrioguruno]
αγριομέλισσα - [agriomelisa]
αγριοράδικο - [agrioradiko]
αγριόπαπια - [agriopapia]
αγριότητα - [agriotita]
αγροσύστημα - [agrosistima]
αγροτική βιοτεχνολογία - [agrotiki biotejnologia]
αγροτική μετεωρολογία - [agrotiki meteorologia]
αγροτική οικολογία - [agrotiki ikologia]
αγροτικό οίκημα - [agrotiko ikima]
αγροτικός πληθυσμός - [agrotikos plizismos]
αγροτουρισμός - [agroturismos]
αγροχημική ουσία - [agrojimiki usia]
αγροχημικός - [agrojimikos]
αγρωστώδη - [agrostodi]
αγρωστώδη φυτά - [agrostodi fita]
αγρόκτημα - [agroktima]
αγρός - [agros]
αγχολυτικό - [agjolitiko]
αγωγή - [agogi]
αγωγιμότητα - [agogimotita]
αγωγός - [agogos]
αγωγός αερίου - [agogos aeriu]
αγόρι - [agori]
αγώνας - [agonas]
αγώνας για επιβίωση - [agonas gia epibiosi]
αδένας - [adenas]
αδέξιος - [adeksios]
αδίκημα εις βάρος του περιβάλλοντος - [adikima is baros tu peribalodos]
αδειάζω - [adiaso]
αδελφοκτονία - [adelfoktonia]
αδελφοκτόνος - [adelfoktonos]
αδελφομιξία - [adelfomiksia]
αδενοσίνη - [adenosini]
αδιάβροχο - [adiabrojo]
αδιάβροχος - [adiabrojos]
αδιάκοπος - [adiakopos]
αδιάλυτη ουσία - [adialiti usia]
αδιακρισία - [adiakrisia]
αδιαπέραστος - [adiaperastos]
αδρανή απόβλητα - [adrani apoblita]
αδυναμία - [adinamia]
αδύνατος - [adinatos]
αεριοποίηση - [aeriopiisi]
αεριοποίηση του άνθρακα - [aeriopiisi tu anzraka]
αεριοχρωματογραφία - [aeriojromatografia]
αερισμός - [aerismos]
αεριωθούμενο - [aeriozumeno]
αεροβιολογία - [aerobiologia]
αεροδρόμιο - [aerodromio]
αεροδυναμικός θόρυβος - [aerodinamikos zoribos]
αερολιμένας - [aerolimenas]
αερολύματα - [aerolimata]
αεροπλάνο - [aeroplano]
αεροπορικές μεταφορές - [aeroporikes metafores]
αεροπορικό δίκαιο - [aeroporiko dikeo]
αεροσκάφος - [aeroskafos]
αεροσυνοδός - [aerosinodos]
αεροφωτογραφία - [aerofotografia]
αερόβια επεξεργασία - [aerobia epeksergasia]
αερόβιες διεργασίες - [aerobies diergasies]
αερόλυμα - [aerolima]
αετιδέας - [aetideas]
αετόπουλο - [aetopulo]
αετός - [aetos]
αζερική - [aseriki]
αζωτοδέσμευση - [asotodesmefsi]
αζωτούχο λίπασμα - [asotujo lipasma]
αθεϊσμός - [azismos]
αθλήτρια - [azlitria]
αθλητής - [azlitis]
αθλητική εγκατάσταση - [azlitiki egkatastasi]
αθλητικό παπούτσι - [azlitiko paputsi]
αθλητικός - [azlitikos]
αθλητικός τύπος - [azlitikos tipos]
αθλητισμός - [azlitismos]
αθλοπαιδιά - [azlopedia]
αθυμία - [azimia]
αιθάλη - [ezali]
αιθάνιο - [ezanio]
αιθέρας - [ezeras]
αιθαλομίχλη - [ezalomijli]
αιθανόλη - [ezanoli]
αιθυλική αλκοόλη - [eziliki alkooli]
αιμάτωμα - [ematoma]
αιματηρός - [ematiros]
αιματολογία - [ematologia]
αιμοπετάλιο - [emopetalio]
αιμορραγία - [emoragia]
αιμοφιλία - [emofilia]
αιολική διάβρωση - [eoliki diabrosi]
αιολική ενέργεια - [eoliki energia]
αισθάνομαι - [eszanome]
αισθητική - [eszitiki]
αισθητικός - [eszitikos]
αισιόδοξος - [esiodoksos]
αιτία - [etia]
αιφνίδια προσβολή - [efnidia prosboli]
αιχμή - [ejmi]
αιχμή βέλους - [ejmi belus]
αιωνιότητα - [eoniotita]
αιώνας - [eonas]
ακάθαρτα έλαια - [akazarta elea]
ακάρεα - [akarea]
ακέφαλος - [akefalos]
ακαθάριστο εγχώριο προϊόν - [akazaristo egjorio prion]
ακαθάριστο εθνικό προϊόν - [akazaristo ezniko prion]
ακακία - [akakia]
ακατάλληλος - [akatalilos]
ακατοίκητος - [akatikitos]
ακκορδεόν - [akkordeon]
ακοή - [akoi]
ακολασία - [akolasia]
ακουστικά - [akustika]
ακουστική - [akustiki]
ακουστική μόνωση - [akustiki monosi]
ακουστική στάθμη - [akustiki stazmi]
ακουστικό φίλτρο - [akustiko filtro]
ακουστότητα - [akustotita]
ακούραστος - [akurastos]
ακούω - [akuo]
ακρίδα - [akrida]
ακρίδα της ερήμου - [akrida tis erimu]
ακριβής - [akribis]
ακριβός - [akribos]
ακροατήριο - [akroatirio]
ακροβάτης - [akrobatis]
ακροστιχίδα - [akrostijida]
ακρωτήριο - [akrotirio]
ακρωτηριάζω - [akrotiriaso]
ακτή - [akti]
ακτίνα - [aktina]
ακτίνες χ - [aktines j]
ακτίνιο - [aktinio]
ακτινίδες - [aktinides]
ακτινοβολία - [aktinobolia]
ακτινοβολία άλφα - [aktinobolia alfa]
ακτινοβολία α - [aktinobolia a]
ακτινοβολία β - [aktinobolia b]
ακτινοβολία βήτα - [aktinobolia bita]
ακτινοβολία περιβάλλοντος - [aktinobolia peribalodos]
ακτινοβολία υποστρώματος - [aktinobolia ipostromatos]
ακτινοβολίες - [aktinobolies]
ακτινοβόληση - [aktinobolisi]
ακτινοβόληση τροφίμων - [aktinobolisi trofimon]
ακτινολογία - [aktinologia]
ακτινοφυσική - [aktinofisiki]
ακτινόμετρο - [aktinometro]
ακτοφυλακή - [aktofilaki]
ακυρώνω - [akirono]
ακόλαστος - [akolastos]
ακόντιο - [akodio]
αλάτι - [alati]
αλάτωση - [alatosi]
αλάτωση εδάφους - [alatosi edafus]
αλάτωση των υδάτων - [alatosi ton idaton]
αλέτρι - [aletri]
αλήθεια - [alizia]
αλίευση - [aliefsi]
αλατούχος - [alatujos]
αλατότητα του εδάφους - [alatotita tu edafus]
αλατότητα του ύδατος - [alatotita tu idatos]
αλατώδης - [alatodis]
αλγορίθμος - [algorizmos]
αλειφατική ένωση - [alifatiki enosi]
αλειφατικός υδρογονάνθρακας - [alifatikos idrogonanzrakas]
αλεξίπτωτο - [aleksiptoto]
αλεξιθυμία - [aleksizimia]
αλεπού - [alepu]
αλευροποιείο - [alefropiio]
αλεύρι - [alefri]
αλιγάτορας - [aligatoras]
αλιεία - [aliia]
αλιεία ανοικτής θαλάσσης - [aliia aniktis zalasis]
αλιεία εσωτερικών υδάτων - [aliia esoterikon idaton]
αλιευτική βιομηχανία - [alieftiki biomijania]
αλιευτικό πεδίο - [alieftiko pedio]
αλιευτικό σκάφος - [alieftiko skafos]
αλικυκλική ένωση - [alikikliki enosi]
αλικυκλικός υδρογονάνθρακας - [alikiklikos idrogonanzrakas]
αλισίβα - [alisiba]
αλκάλια - [alkalia]
αλκάνιο - [alkanio]
αλκαλικές γαίες - [alkalikes gees]
αλκαλική έκταση - [alkaliki ektasi]
αλκαλική ένωση - [alkaliki enosi]
αλκαλική μπαταρία - [alkaliki bataria]
αλκαλικό έδαφος - [alkaliko edafos]
αλκοολικός - [alkoolikos]
αλκοόλη - [alkooli]
αλκοόλη αιθυλική - [alkooli eziliki]
αλκυλική ένωση - [alkiliki enosi]
αλλάζω - [alaso]
αλλαγή - [alagi]
αλλεργία - [alergia]
αλλεργιογόνο - [alergiogono]
αλληγορία - [aligoria]
αλληλεπίδραση μεταξύ γης και ηλίου - [alilepidrasi metaksi gis ke iliu]
αλληλεπίδραση των φυτοφαρμάκων - [alilepidrasi ton fitofarmakon]
αλλοδαπός - [alodapos]
αλλομετρία - [alometria]
αλλοτροπία - [alotropia]
αλλού - [alu]
αλμανάκ - [almanak]
αλμπάνης - [albanis]
αλμυρά ύδατα - [almira idata]
αλμυρός - [almiros]
αλμυρός βάλτος - [almiros baltos]
αλμυρός λειμώνας - [almiros limonas]
αλογονωμένη ένωση - [alogonomeni enosi]
αλογονωμένη φαινόλη - [alogonomeni fenoli]
αλογονωμένο διφαινύλιο - [alogonomeno difenilio]
αλογονωμένος υδρογονάνθρακας - [alogonomenos idrogonanzrakas]
αλουμίνα - [alumina]
αλουμίνιο - [aluminio]
αλυκή - [aliki]
αλυκό - [aliko]
αλυσοπρίονο - [alisopriono]
αλυτρωτισμός - [alitrotismos]
αλφάβητος - [alfabitos]
αλχημεία - [aljimia]
αλχημιστής - [aljimistis]
αμάλγαμα - [amalgama]
αμέσως - [amesos]
αμίαντος - [amiados]
αμίνη - [amini]
αμαξοστοιχία - [amaksostijia]
αμειψισπορά - [amipsispora]
αμερίκιο - [amerikio]
αμην - [amin]
αμιαντίαση - [amiadiasi]
αμιαντοτσιμέντο - [amiadotsimedo]
αμινοξύ - [aminoksi]
αμμοθίνα - [amozina]
αμμοθύελλα - [amoziela]
αμμοληψία - [amolipsia]
αμμοχάλικο - [amojaliko]
αμμωνία - [amonia]
αμμωνιοποίηση - [amoniopiisi]
αμμόλοφος - [amolofos]
αμμώνιο - [amonio]
αμνός - [amnos]
αμοιβή - [amibi]
αμπέρ - [aber]
αμπαζούρ - [abasur]
αμπελοκαλλιέργεια - [abelokaliergia]
αμπελουργία - [abelurgia]
αμπελώνας - [abelonas]
αμυγδαλίτιδα - [amigdalitida]
αμυγδαλεκτομή - [amigdalektomi]
αμφίβια - [amfibia]
αμφίβιος - [amfibios]
αμφίστομος - [amfistomos]
αμφεταμίνη - [amfetamini]
αμφιβληστροειδής - [amfiblistroidis]
αμφιθέατρο - [amfizeatro]
αμφορέας - [amforeas]
αμόλυβδη βενζίνη - [amolibdi bensini]
αμώνι - [amoni]
ανάβω - [anabo]
ανάγγειος - [anagios]
ανάγκη - [anagki]
ανάγλυφο του εδάφους - [anaglifo tu edafus]
ανάδοχος του έργου καθαρισμού - [anadojos tu ergu kazarismu]
ανάθεμα - [anazema]
ανάκτηση ενέργειας - [anaktisi energias]
ανάλυση δεδομένων - [analisi dedomenon]
ανάλυση διαδικασίας - [analisi diadikasias]
ανάλυση ευαισθησίας - [analisi efeszisias]
ανάλυση θορύβου - [analisi zoribu]
ανάλυση κινδύνου - [analisi kindinu]
ανάλυση κινδύνου-οφέλους - [analisi kindinu-ofelus]
ανάλυση κόστους-οφέλους - [analisi kostus-ofelus]
ανάλυση συστημάτων - [analisi sistimaton]
ανάμεικτος - [anamiktos]
ανάμειξη - [anamiksi]
ανάπηρος - [anapiros]
ανάπτυξη λογισμικού - [anaptiksi logismiku]
ανάρτηση - [anartisi]
ανάστροφη ώσμωση - [anastrofi osmosi]
ανάσχεση - [anasjesi]
ανάχωμα - [anajoma]
ανέκδοτο - [anekdoto]
ανήλικος - [anilikos]
ανία - [ania]
ανίατος - [aniatos]
ανίχνευση - [anijnefsi]
αναβλάστηση - [anablastisi]
αναγέννηση - [anagenisi]
αναγγελία - [anagelia]
αναγγελία κινδύνου - [anagelia kindinu]
αναγνώριση μορφών - [anagnorisi morfon]
αναδάσωση - [anadasosi]
αναδασμός - [anadasmos]
αναδιάταξη - [anadiataksi]
αναδοχή - [anadoji]
αναθυμιάσεις - [anazimiasis]
ανακαίνιση - [anakenisi]
ανακλασιμετρία - [anaklasimetria]
ανακοίνωση - [anakinosi]
ανακρίνω - [anakrino]
ανακριτής - [anakritis]
ανακυκλωμένο χαρτί - [anakiklomeno jarti]
ανακύκληση - [anakiklisi]
ανακύκληση αποβλήτων - [anakiklisi apobliton]
αναλογία - [analogia]
αναλυτική μέθοδος - [analitiki mezodos]
αναλυτική χημεία - [analitiki jimia]
αναμιγνύω - [anamignio]
αναμιξιμότητα - [anamiksimotita]
αναμόρφωση - [anamorfosi]
ανανάς - [ananas]
ανανέωση των υδάτων - [ananeosi ton idaton]
ανανεώσιμη πρώτη ύλη - [ananeosimi proti ili]
ανανεώσιμοι πόροι - [ananeosimi pori]
αναπαραγωγή - [anaparagogi]
αναπαραγωγή των ζώων - [anaparagogi ton soon]
αναπαύομαι - [anapafome]
αναπαύομαι στις δάφνες μου - [anapafome stis dafnes mu]
αναπνέω - [anapneo]
αναπνευστική οδός - [anapnefstiki odos]
αναπνευστικό νόσημα - [anapnefstiko nosima]
αναπνοή - [anapnoi]
αναπτήρας - [anaptiras]
αναπτυξιακή βοήθεια - [anaptiksiaki boizia]
αναπτυξιακή περιοχή - [anaptiksiaki perioji]
αναπτυξιακός σχεδιασμός - [anaptiksiakos sjediasmos]
αναπτυσσόμενες χώρες - [anaptisomenes jores]
αναρχικός - [anarjikos]
αναρχισμός - [anarjismos]
ανασκαφέν άνοιγμα - [anaskafen anigma]
ανασκαφή - [anaskafi]
αναστήλωση - [anastilosi]
αναστροφή - [anastrofi]
ανατίναξη - [anatinaksi]
αναταραχή - [anataraji]
ανατολή - [anatoli]
ανατομία - [anatomia]
ανατροφή - [anatrofi]
αναφορτώνω - [anafortono]
αναφόρτωση - [anafortosi]
αναχαίτιση - [anajetisi]
αναχωρώ - [anajoro]
αναχώρηση - [anajorisi]
αναψυχή - [anapsiji]
ανεμιστήρας - [anemistiras]
ανεμοστρόβιλος - [anemostrobilos]
ανεμόμυλος - [anemomilos]
ανεξαρτησία - [aneksartisia]
ανεπτυγμένες χώρες - [aneptigmenes jores]
ανεργία - [anergia]
ανησυχώ - [anisijo]
ανθήλη - [anzili]
ανθίζω - [anziso]
ανθεκτικότητα - [anzektikotita]
ανθεκτικότητα των φυτοφαρμάκων - [anzektikotita ton fitofarmakon]
ανθοκράμβη - [anzokrambi]
ανθολογία - [anzologia]
ανθρακικό - [anzrakiko]
ανθρακικό άλας - [anzrakiko alas]
ανθρακικό νάτριο - [anzrakiko natrio]
ανθρακούχος - [anzrakujos]
ανθρωπιστικές επιστήμες - [anzropistikes epistimes]
ανθρωπιστική βοήθεια - [anzropistiki boizia]
ανθρωπογενής καταστροφή - [anzropogenis katastrofi]
ανθρωπογενής μεταβολή του κλίματος - [anzropogenis metaboli tu klimatos]
ανθρωπομορφισμός - [anzropomorfismos]
ανθρωποσφαγή - [anzroposfagi]
ανθρωποφαγία - [anzropofagia]
ανθρωπότητα - [anzropotita]
ανθρώπινα δικαιώματα - [anzropina dikeomata]
ανθρώπινη βιολογία - [anzropini biologia]
ανθρώπινη δραστηριότητα - [anzropini drastiriotita]
ανθρώπινη παθολογία - [anzropini pazologia]
ανθρώπινη υγεία - [anzropini igia]
ανθρώπινη φυσιολογία - [anzropini fisiologia]
ανθρώπινο δυναμικό - [anzropino dinamiko]
ανθρώπινο σώμα - [anzropino soma]
ανθυγιεινός - [anzigiinos]
ανθός - [anzos]
ανθώ - [anzo]
ανιαρός - [aniaros]
ανικανοποίητος - [anikanopiitos]
ανιψιά - [anipsia]
ανιψιός - [anipsios]
ανιόν - [anion]
ανοίγω - [anigo]
ανοικτή θάλασσα - [anikti zalasa]
ανοικτός χλοοτάπητας - [aniktos jlootapitas]
ανοιχτήρι - [anijtiri]
ανοιχτός - [anijtos]
ανοσολογία - [anosologia]
ανοσολογική ασθένεια - [anosologiki aszenia]
ανοσοποιητικό σύστημα - [anosopiitiko sistima]
ανοσοπροσδιορισμός - [anosoprosdiorismos]
ανοϊκός - [anikos]
αντίδι - [adidi]
αντίδοτο - [adidoto]
αντίθετο - [adizeto]
αντίθετος - [adizetos]
αντίκρουση - [adikrusi]
αντίληψη του κινδύνου - [adilipsi tu kindinu]
αντίπαπας - [adipapas]
αντίρρηση - [adirisi]
αντίσωμα - [adisoma]
αντίχειρας - [adijiras]
ανταγωνισμός - [adagonismos]
ανταγωνιστική εξέταση - [adagonistiki eksetasi]
ανταγωνιστικότητα - [adagonistikotita]
ανταλλαγή αποβλήτων - [adalagi apobliton]
ανταλλαγή δεδομένων - [adalagi dedomenon]
ανταλλαγή πληροφοριών - [adalagi pliroforion]
ανταμοιβή - [adamibi]
αντανάκλαση - [adanaklasi]
αντασφαλιστής - [adasfalistis]
αντηχείο - [adijio]
αντιβιοτικό - [adibiotiko]
αντιδραστήρας - [adidrastiras]
αντιδραστήρας ταχέων νετρονίων - [adidrastiras tajeon netronion]
αντιθορυβική προστασία - [adizoribiki prostasia]
αντικατάσταση - [adikatastasi]
αντικαταθλιπτικό - [adikatazliptiko]
αντικαταθλιπτικός - [adikatazliptikos]
αντικατοπτρισμός - [adikatoptrismos]
αντιμετώπιση - [adimetopisi]
αντιμετώπιση της ξηρασίας - [adimetopisi tis ksirasias]
αντιμικροβιακός - [adimikrobiakos]
αντιμόνιο - [adimonio]
αντιξοότητα - [adiksootita]
αντιπάπας - [adipapas]
αντιπαρασιτική οργανική ένωση - [adiparasitiki organiki enosi]
αντιπλημυρική προστασία - [adiplimiriki prostasia]
αντιπρωτόνιο - [adiprotonio]
αντιπρόεδρος - [adiproedros]
αντιπτέριση - [adipterisi]
αντιρρυπαντική τεχνολογία - [adiripadiki tejnologia]
αντιρρόπηση - [adiropisi]
αντισημιτισμός - [adisimitismos]
αντιστάθμιση - [adistazmisi]
αντισυλληπτικό - [adisiliptiko]
αντισφαίριση - [adisferisi]
αντλία - [adlia]
αντλία θερμότητας - [adlia zermotitas]
αντλία νερού - [adlia neru]
αντοχή υλικών - [adoji ilikon]
αντσούγια - [adsugia]
αντώνυμο - [adonimo]
ανυπακοή - [anipakoi]
ανυπεράσπιστος - [aniperaspistos]
ανόργανη ουσία - [anorgani usia]
ανόργανη χημεία - [anorgani jimia]
ανόργανο λίπασμα - [anorgano lipasma]
ανώτατος - [anotatos]
ανώτερος - [anoteros]
ανώφλι - [anofli]
αξίωμα - [aksioma]
αξίωση - [aksiosi]
αξιολόγηση - [aksiologisi]
αξιολόγηση της τεχνολογίας - [aksiologisi tis tejnologias]
αξιοποίηση του τοπίου - [aksiopiisi tu topiu]
αξιοποίηση των υδάτων - [aksiopiisi ton idaton]
αξιοποίηση των φυτοφαρμάκων - [aksiopiisi ton fitofarmakon]
αξιοσημείωτος - [aksiosimiotos]
αξιόγραφο - [aksiografo]
αορτή - [aorti]
απάτη - [apati]
απέραντος - [aperados]
απέριττος - [aperitos]
απίστευτο - [apistefto]
απαέρια - [apaeria]
απαίτηση - [apetisi]
απαγωγή - [apagogi]
απαγόρευση - [apagorefsi]
απαερίωση στο χώρο ταφής απορριμμάτων - [apaeriosi sto joro tafis aporimaton]
απαερίωση των αποβλήτων - [apaeriosi ton apobliton]
απαιτούμενες βασικές τροφές - [apetumenes basikes trofes]
απαλλαγή - [apalagi]
απαλλοτριώνω - [apalotriono]
απαντώ - [apado]
απαρχαιούμενος - [aparjeumenos]
απασχόληση - [apasjolisi]
απατεών - [apateon]
απείθεια - [apizia]
απειλητικά - [apilitika]
απερήμωση - [aperimosi]
απεργία - [apergia]
αποβάθρα - [apobazra]
αποβαλλόμενα ύδατα - [apobalomena idata]
αποβολή - [apoboli]
απογαλακτίζω - [apogalaktiso]
απογειώνομαι - [apogionome]
απογραφή - [apografi]
αποδάσωση - [apodasosi]
αποδέκτης - [apodektis]
αποδέσμευση - [apodesmefsi]
αποδεικνύω - [apodiknio]
αποδεκατίζω - [apodekatiso]
αποδημητικό είδος - [apodimitiko idos]
αποδιοπομπαίος τράγος - [apodiopobeos tragos]
αποδοχή - [apodoji]
αποζημίωση - [aposimiosi]
αποθήκευση - [apozikefsi]
αποθήκη - [apoziki]
αποθείωση - [apoziosi]
αποικισμός - [apikismos]
αποκάλυψη - [apokalipsi]
αποκέντρωση - [apokedrosi]
αποκατάσταση - [apokatastasi]
αποκατάσταση κτηρίου - [apokatastasi ktiriu]
αποκατάσταση της χλωρίδας - [apokatastasi tis jloridas]
αποκεντρώνω - [apokedrono]
αποκονίωση - [apokoniosi]
αποκρίνομαι - [apokrinome]
απολίθωμα - [apolizoma]
απολίπανση - [apolipansi]
απολαυστικός - [apolafstikos]
απολυμαντικό - [apolimadiko]
απολυταρχία - [apolitarjia]
απολυταρχικός - [apolitarjikos]
απολύμανση - [apolimansi]
απολύμανση του εδάφους - [apolimansi tu edafus]
απομάκρυνση - [apomakrinsi]
απομελάνωση - [apomelanosi]
απομόνωση - [apomonosi]
αποξήρανση - [apoksiransi]
απορία - [aporia]
απορρίμματα από γυαλί - [aporimata apo giali]
απορρίμματα από γύψο - [aporimata apo gipso]
απορρίμματα κήπου - [aporimata kipu]
απορρίμματα πλοίου - [aporimata pliu]
απορρίμματα χαρτιού - [aporimata jartiu]
απορροή - [aporoi]
απορρυπαντικό - [aporipadiko]
απορρόφηση - [aporofisi]
απορρύπανση - [aporipansi]
αποσμητικό - [aposmitiko]
αποστάτης - [apostatis]
αποστείρωση - [apostirosi]
αποστράγγιση - [apostragisi]
αποστρέφω - [apostrefo]
αποτέφρωση - [apotefrosi]
αποτέφρωση των αποβλήτων - [apotefrosi ton apobliton]
αποτίμηση - [apotimisi]
αποταμίευση - [apotamiefsi]
αποταμιευτής - [apotamieftis]
αποτελέσματα - [apotelesmata]
αποτεφρωτής - [apotefrotis]
αποτοξίκωση - [apotoksikosi]
αποτοξίνωση - [apotoksinosi]
αποτρέπω - [apotrepo]
αποτροπή - [apotropi]
αποτυχία - [apotijia]
αποφάσεις - [apofasis]
αποφεύγω - [apofefgo]
αποχέτευση - [apojetefsi]
αποχλωρίωση - [apojloriosi]
αποχωρητήριο - [apojoritirio]
αποψίλωση - [apopsilosi]
αποϊονισμός του νερού - [apionismos tu neru]
από τα κομόρος - [apo ta komoros]
απόβλητα - [apoblita]
απόβλητα ελαστικού - [apoblita elastiku]
απόβλητα εργαστηρίου - [apoblita ergastiriu]
απόβλητα σφαγείου - [apoblita sfagiu]
απόδειπνο - [apodipno]
απόδημος - [apodimos]
απόδοση - [apodosi]
απόθεμα - [apozema]
απόθεμα της βιόσφαιρας - [apozema tis biosferas]
απόκριες - [apokries]
απόρριψη πετρελαίου - [aporipsi petreleu]
απόρριψη στους ωκεανούς - [aporipsi stus okeanus]
απόσταξη - [apostaksi]
απόστημα - [apostima]
απόστροφος - [apostrofos]
απότομος - [apotomos]
απόφαση - [apofasi]
απόφθεγμα - [apofzegma]
απόχρωση - [apojrosi]
απώλεια - [apolia]
απώλεια βιοτόπου - [apolia biotopu]
αράχνη - [arajni]
αραβικά - [arabika]
αραβική - [arabiki]
αραβόσιτος - [arabositos]
αραιωμένο οξύ - [areomeno oksi]
αραχνοειδή - [arajnoidi]
αραχνοφοβία - [arajnofobia]
αργία - [argia]
αργίλιο - [argilio]
αργκό - [argko]
αργοπορημένος - [argoporimenos]
αργοτική - [argotiki]
αργό - [argo]
αργό πετρέλαιο - [argo petreleo]
αργός - [argos]
αρδευτική καλλιέργεια - [ardeftiki kaliergia]
αρδευτική τάφρος - [ardeftiki tafros]
αρθρίτιδα - [arzritida]
αρθρωτά - [arzrota]
αρθρόποδα - [arzropoda]
αριάνι - [ariani]
αριθμός - [arizmos]
αριθμός αβογκάντρο - [arizmos abogkadro]
αρκούδα - [arkuda]
αρκτίδες - [arktides]
αρκτόμυς - [arktomis]
αρμέγω - [armego]
αρμενικά - [armenika]
αρμοδιότητα - [armodiotita]
αρνί - [arni]
αροτραία καλλιέργεια - [arotrea kaliergia]
αρπακτικό - [arpaktiko]
αρπακτικό πτηνό - [arpaktiko ptino]
αρρώστια - [arostia]
αρσενικό - [arseniko]
αρσενικός - [arsenikos]
αρτηρία - [artiria]
αρτοποιείο - [artopiio]
αρτοποιός - [artopios]
αρχίζω - [arjiso]
αρχίπτερα - [arjiptera]
αρχαία ελληνική γλώσσα - [arjea eliniki glosa]
αρχαίος - [arjeos]
αρχαιολογία - [arjeologia]
αρχαιολογική θέση - [arjeologiki zesi]
αρχαιολογική τοποθεσία - [arjeologiki topozesia]
αρχείο - [arjio]
αρχειοθετώ - [arjiozeto]
αρχιεπίσκοπος - [arjiepiskopos]
αρχική ιστοσελίδα - [arjiki istoselida]
αρχική κατάρτιση - [arjiki katartisi]
αρχιμάγειρος - [arjimagiros]
αρχιπέλαγος - [arjipelagos]
αρχιτέκτονας - [arjitektonas]
αρχιτεκτονική - [arjitektoniki]
αρχιτεκτονική τοπίου - [arjitektoniki topiu]
αρωματική ένωση - [aromatiki enosi]
αρωματική ουσία - [aromatiki usia]
αρωματικός υδρογονάνθρακας - [aromatikos idrogonanzrakas]
αρωματικός χαρακτήρας - [aromatikos jaraktiras]
ασανσέρ - [asanser]
ασβέστιο - [asbestio]
ασβεστόλιθος - [asbestolizos]
ασεξουαλικότητα - [aseksualikotita]
ασθένεια - [aszenia]
ασθένεια chagas - [aszenia chagas]
ασθένεια των ιχθύων - [aszenia ton ijzion]
ασθένεια των φυτών - [aszenia ton fiton]
ασθενής - [aszenis]
ασθενής ομίχλη - [aszenis omijli]
ασθενόσφαιρα - [aszenosfera]
ασκαλώνιο - [askalonio]
ασκητής - [askitis]
ασκούμαι - [askume]
ασπράδι - [aspradi]
ασπόνδυλα - [aspondila]
αστάθεια - [astazia]
αστέρι - [asteri]
αστακός - [astakos]
αστερίας - [asterias]
αστερίσκος - [asteriskos]
αστερισμός - [asterismos]
αστιγματισμός - [astigmatismos]
αστική ανάπτυξη - [astiki anaptiksi]
αστική κυκλοφορία - [astiki kikloforia]
αστική πίεση - [astiki piesi]
αστική περιοχή - [astiki perioji]
αστική τάξη - [astiki taksi]
αστική ύδρευση - [astiki idrefsi]
αστικοποίηση - [astikopiisi]
αστικό δίκαιο - [astiko dikeo]
αστικό κέντρο - [astiko kedro]
αστικό πράσινο - [astiko prasino]
αστικό τοπίο - [astiko topio]
αστικός πληθυσμός - [astikos plizismos]
αστοχώ - [astojo]
αστράγαλος - [astragalos]
αστραπή - [astrapi]
αστρολάβος ιππάρχου - [astrolabos iparju]
αστρολάβος των αντικυθήρων - [astrolabos ton adikiziron]
αστρολογία - [astrologia]
αστρομετρία - [astrometria]
αστροναυτική - [astronaftiki]
αστρονομία - [astronomia]
αστρονομικός - [astronomikos]
αστυνομία - [astinomia]
αστυνομικό δίκαιο - [astinomiko dikeo]
αστυνομικό τμήμα - [astinomiko tmima]
αστυνομικός - [astinomikos]
ασυμφωνία - [asimfonia]
ασφάλεια - [asfalia]
ασφάλεια του αντιδραστήρα - [asfalia tu adidrastira]
ασφάλιση - [asfalisi]
ασφάλιση για ρύπανση - [asfalisi gia ripansi]
ασφάλιστρο - [asfalistro]
ασφαλιστική κάλυψη - [asfalistiki kalipsi]
ασύμμετρο - [asimetro]
ασύρματος - [asirmatos]
ασώματος - [asomatos]
αταξία - [ataksia]
ατμογεννήτρια - [atmogenitria]
ατμολέβητας - [atmolebitas]
ατμοσφαιρική αναταραχή - [atmosferiki anataraji]
ατμοσφαιρική διόρθωση - [atmosferiki diorzosi]
ατμοσφαιρική κατακρήμνιση - [atmosferiki katakrimnisi]
ατμοσφαιρική ρύπανση - [atmosferiki ripansi]
ατμοσφαιρική υγρασία - [atmosferiki igrasia]
ατμοσφαιρική φυσική - [atmosferiki fisiki]
ατμοσφαιρικό αερόλυμα - [atmosferiko aerolima]
ατμοσφαιρικό μοντέλο - [atmosferiko modelo]
ατμοσφαιρικό όζον - [atmosferiko oson]
ατμοσφαιρικός - [atmosferikos]
ατμόσφαιρα - [atmosfera]
ατομική μάζα - [atomiki masa]
ατραζίνη - [atrasini]
ατυχήματα - [atijimata]
αυγό - [afgo]
αυθαίρετο - [afzereto]
αυλακοποίηση ποταμού - [aflakopiisi potamu]
αυξάνω - [afksano]
αυστριακός - [afstriakos]
αυτάρεσκος - [aftareskos]
αυτί - [afti]
αυτογκόλ - [aftogkol]
αυτοκίνητο όχημα - [aftokinito ojima]
αυτοκαθαρισμός - [aftokazarismos]
αυτοκανιβαλισμός - [aftokanibalismos]
αυτοκινητοβιομηχανία - [aftokinitobiomijania]
αυτοκινητόδρομος - [aftokinitodromos]
αυτοκτονία - [aftoktonia]
αυτονομία - [aftonomia]
αυτοοικολογία - [aftoikologia]
αυτοσχεδιασμός - [aftosjediasmos]
αυτοψία - [aftopsia]
αυτόνομο νευρικό σύστημα - [aftonomo nefriko sistima]
αυτόπτης μάρτυρας - [aftoptis martiras]
αυτόχθον δάσος - [aftojzon dasos]
αυχένας - [afjenas]
αφαίρεση - [aferesi]
αφαίρεση φωσφορικών αλάτων - [aferesi fosforikon alaton]
αφαιρετική - [aferetiki]
αφαιρετικός - [aferetikos]
αφαλάτωση - [afalatosi]
αφαλάτωση του ύδατος - [afalatosi tu idatos]
αφγανικός - [afganikos]
αφηρημένη - [afirimeni]
αφομοίωση - [afomiosi]
αφομοιώνω - [afomiono]
αφρίζον μέσο - [afrison meso]
αφρικάνικα - [afrikanika]
αφρικανικός - [afrikanikos]
αφυπνίζω - [afipniso]
αχάριστος - [ajaristos]
αχαμνά - [ajamna]
αχινός - [ajinos]
αχλάδι - [ajladi]
αχλαδιά - [ajladia]
αχλύς - [ajlis]
αχνός - [ajnos]
αχρωματοψία - [ajromatopsia]
αχυρώνας - [ajironas]
αϊνστάνιο - [enstanio]
αϋπνία - [afpnia]
αύξηση του πληθυσμού - [afksisi tu plizismu]
αύριο - [afrio]
βάζω - [baso]
βάλτος - [baltos]
βάπτισμα - [baptisma]
βάραθρο - [barazro]
βάριο - [bario]
βάση - [basi]
βάση δεδομένων - [basi dedomenon]
βάτου - [batu]
βάφω - [bafo]
βέλος - [belos]
βένθος - [benzos]
βήχας - [bijas]
βήχω - [bijo]
βίδα - [bida]
βίντεο - [bideo]
βίσονας - [bisonas]
βαθμός - [bazmos]
βαθμός οξύτητας - [bazmos oksititas]
βαθούλωμα - [bazuloma]
βαθύς - [bazis]
βακαλάος - [bakalaos]
βακτήρια - [baktiria]
βακτηρίδια - [baktiridia]
βακτηρίδια των κοπράνων - [baktiridia ton kopranon]
βακτηριολογία - [baktiriologia]
βακτηριολογική κλίνη - [baktiriologiki klini]
βαλάντιο - [baladio]
βαλανιδιά - [balanidia]
βαλλίστρα - [balistra]
βαλλωνικά - [balonika]
βαμβάκι - [bambaki]
βανάδιο - [banadio]
βανδαλισμός - [bandalismos]
βαπτιστικό - [baptistiko]
βαρβαρότητα - [barbarotita]
βαρβιτουρικό - [barbituriko]
βαρετός - [baretos]
βαρκα - [barka]
βαρογράφος - [barografos]
βαρόμετρο - [barometro]
βαρύ μέταλλο - [bari metalo]
βαρύ ύδωρ - [bari idor]
βαρύς - [baris]
βαρύτονος - [baritonos]
βασίλειο - [basilio]
βασίλισσα - [basilisa]
βασανίζω - [basaniso]
βασανιστήρια - [basanistiria]
βασιδιομύκης - [basidiomikis]
βασική παρακολούθηση - [basiki parakoluzisi]
βασική τροφή - [basiki trofi]
βασικότητα - [basikotita]
βασιλιάς - [basilias]
βασιλοκτονία - [basiloktonia]
βασιλοκτόνος - [basiloktonos]
βασκικά - [baskika]
βαφή - [bafi]
βαφτίσια - [baftisia]
βγάζω έξω - [bgaso ekso]
βεβήλωση - [bebilosi]
βεβαιότητα - [bebeotita]
βεβαιώνω - [bebeono]
βελανίδι - [belanidi]
βελανιδιά - [belanidia]
βελονισμός - [belonismos]
βελονιστής - [belonistis]
βελούδο - [beludo]
βελτίωση της στέγασης - [beltiosi tis stegasis]
βελτίωση του εδάφους - [beltiosi tu edafus]
βελόνα - [belona]
βενζένιο - [bensenio]
βενζίνη - [bensini]
βενζινάδικο - [bensinadiko]
βενζινοκινητήρας - [bensinokinitiras]
βενζοδιαζεπίνη - [bensodiasepini]
βενζοπυρένιο - [bensopirenio]
βενζόλη - [bensoli]
βενζόλιο - [bensolio]
βενθική ζώνη - [benziki soni]
βενθικό οικοσύστημα - [benziko ikosistima]
βερίκοκο - [berikoko]
βερνίκι - [berniki]
βετεράνος - [beteranos]
βηρύλλιο - [birilio]
βιασμός - [biasmos]
βιβλίο - [biblio]
βιβλιογραφία - [bibliografia]
βιβλιογραφικές πληροφορίες - [bibliografikes plirofories]
βιβλιοθήκη - [biblioziki]
βιβλιοθηκάριος - [bibliozikarios]
βιδώνω - [bidono]
βιετναμέζικα - [bietnamesika]
βιοαέριο - [bioaerio]
βιοαντιδραστήρας - [bioadidrastiras]
βιοαποδομησιμότητα - [bioapodomisimotita]
βιοασφάλεια - [bioasfalia]
βιογενές καύσιμο - [biogenes kafsimo]
βιογεωγραφία - [biogeografia]
βιογεωγραφικές περιοχές - [biogeografikes periojes]
βιογεωχημεία - [biogeojimia]
βιογεωχημικός κύκλος - [biogeojimikos kiklos]
βιογραφία - [biografia]
βιοδείκτης - [biodiktis]
βιοδιήθηση - [biodiizisi]
βιοδιαθεσιμότητα - [biodiazesimotita]
βιοδιασπασιμότητα - [biodiaspasimotita]
βιοηθική - [bioiziki]
βιοκλιματολογία - [bioklimatologia]
βιοκοινωνία - [biokinonia]
βιοκτόνο - [bioktono]
βιολί - [bioli]
βιολογία - [biologia]
βιολογία γλυκών υδάτων - [biologia glikon idaton]
βιολογία ποταμοκόλπων - [biologia potamokolpon]
βιολογικές επιστήμες - [biologikes epistimes]
βιολογική δέσμευση αζώτου - [biologiki desmefsi asotu]
βιολογική καλλιέργεια - [biologiki kaliergia]
βιολογική καταπολέμηση των παρασίτων - [biologiki katapolemisi ton parasiton]
βιολογική μηχανική - [biologiki mijaniki]
βιολογική παρακολούθηση - [biologiki parakoluzisi]
βιολογική φωτοβολία - [biologiki fotobolia]
βιολογικό όπλο - [biologiko oplo]
βιολογικός δείκτης - [biologikos diktis]
βιολοντσέλο - [biolodselo]
βιομάζα - [biomasa]
βιομηχανία - [biomijania]
βιομηχανία επεξεργασίας καουτσούκ - [biomijania epeksergasias kautsuk]
βιομηχανία καλλυντικών - [biomijania kalidikon]
βιομηχανία παραγωγής ενέργειας - [biomijania paragogis energias]
βιομηχανία ποτών - [biomijania poton]
βιομηχανικά απόβλητα - [biomijanika apoblita]
βιομηχανική ασφάλεια - [biomijaniki asfalia]
βιομηχανική εγκατάσταση - [biomijaniki egkatastasi]
βιομηχανική ιατρική - [biomijaniki iatriki]
βιομηχανική ιλύς - [biomijaniki ilis]
βιομηχανική κοινωνία - [biomijaniki kinonia]
βιομηχανική περιοχή - [biomijaniki perioji]
βιομηχανικός χώρος - [biomijanikos joros]
βιονική - [bioniki]
βιονικός - [bionikos]
βιοποικιλότητα - [biopikilotita]
βιορυθμός - [biorizmos]
βιοσυσσώρευση - [biosisorefsi]
βιοσύνθεση - [biosinzesi]
βιοτεχνολογία - [biotejnologia]
βιοτικό επίπεδο - [biotiko epipedo]
βιοτικός δείκτης - [biotikos diktis]
βιοτικός παράγοντας - [biotikos paragodas]
βιοφυσική - [biofisiki]
βιοφωσφορισμός - [biofosforismos]
βιοφωταύγεια - [biofotafgia]
βιοχημεία - [biojimia]
βισμούθιο - [bismuzio]
βιταμίνη - [bitamini]
βιόλα - [biola]
βιόσφαιρα - [biosfera]
βιότοπος - [biotopos]
βιώσιμη ανάπτυξη - [biosimi anaptiksi]
βλάβη - [blabi]
βλάβη από ακτινοβολία - [blabi apo aktinobolia]
βλάβη στο δάσος - [blabi sto dasos]
βλάστηση - [blastisi]
βλάστηση βυθού - [blastisi bizu]
βλέπω - [blepo]
βλέφαρο - [blefaro]
βλέψη - [blepsi]
βλασφημία - [blasfimia]
βλεφαρίδα - [blefarida]
βοήθεια - [boizia]
βοήθεια για την αντιμετώπιση καταστροφής - [boizia gia tin adimetopisi katastrofis]
βοδινό - [bodino]
βοηθάω - [boizao]
βοηθώ - [boizo]
βολή - [boli]
βολβός του ματιού - [bolbos tu matiu]
βολφράμιο - [bolframio]
βομβαρδίζω - [bombardiso]
βοοειδή - [booidi]
βορράς - [boras]
βοσκή - [boski]
βοσκός - [boskos]
βοσκότοπος - [boskotopos]
βοσνιακά - [bosniaka]
βοτανική - [botaniki]
βοτανικός κήπος - [botanikos kipos]
βοτανολογία - [botanologia]
βουβουζέλα - [bubusela]
βουβωνική πανώλη - [buboniki panoli]
βουβωνική χώρα - [buboniki jora]
βουβώνας - [bubonas]
βουδισμός - [budismos]
βουλγάρικα - [bulgarika]
βουλγάρικος - [bulgarikos]
βουλγαρικά - [bulgarika]
βουλγαρικός - [bulgarikos]
βουλκανισμός - [bulkanismos]
βουρτσίζω - [burtsiso]
βούτυρο - [butiro]
βράγχιο - [bragjio]
βράδυ - [bradi]
βράσει - [brasi]
βράχος - [brajos]
βρέφος - [brefos]
βρίσκω - [brisko]
βραβείο - [brabio]
βραδινό - [bradino]
βραδυσεισμός - [bradisismos]
βραχιολι - [brajioli]
βραχιονας - [brajionas]
βραχυκύκλωμα - [brajikikloma]
βραχυπρόθεσμος - [brajiprozesmos]
βρετονικά - [bretonika]
βρεφική θνησιμότητα - [brefiki znisimotita]
βροντή - [brodi]
βροχή - [broji]
βροχερός - [brojeros]
βρυόφυτα - [briofita]
βρόμιο - [bromio]
βρώμη - [bromi]
βρώσιμο λίπος - [brosimo lipos]
βυζαντινός - [bisadinos]
βωξίτης - [boksitis]
βόδι - [bodi]
βόεϊος - [boios]
βόλεϋ - [bolef]
βόμβα - [bomba]
βόμβος - [bombos]
βόρβορος - [borboros]
βόριο - [borio]
βόσκηση - [boskisi]
βόσκω - [bosko]
βύνη - [bini]
γάιδαρος - [gedaros]
γάλα - [gala]
γάλλιο - [galio]
γάμος - [gamos]
γάμπα - [gaba]
γάντι - [gadi]
γάρο - [garo]
γάτος - [gatos]
γέλιο - [gelio]
γέννηση - [genisi]
γένος - [genos]
γέφυρα - [gefira]
γήινος φλοιός - [giinos flios]
γήλοφος - [gilofos]
γήπαιδο αθλοπαιδιών - [gipedo azlopedion]
γίνομαι - [ginome]
γαδολίνιο - [gadolinio]
γαιάνθρακας - [geanzrakas]
γαλάζιο - [galasio]
γαλάκτωμα - [galaktoma]
γαλακτοβιομηχανία - [galaktobiomijania]
γαλακτοκομικό προϊόν - [galaktokomiko prion]
γαλακτωματοποίηση - [galaktomatopiisi]
γαλανό - [galano]
γαλβανόμετρο - [galbanometro]
γαλικιακά - [galikiaka]
γαλλικά - [galika]
γαλλικός - [galikos]
γαλοπούλα - [galopula]
γαμπρός - [gabros]
γαστήρ - [gastir]
γαστερόποδα - [gasteropoda]
γαστρίτιδα - [gastritida]
γατόπαρδος - [gatopardos]
γδέρνω - [gderno]
γεγονός - [gegonos]
γεια - [gia]
γελάω - [gelao]
γεμολογία - [gemologia]
γενέθλια - [genezlia]
γενεά - [genea]
γενεαλογικός - [genealogikos]
γενετικά τροποποιημένος οργανισμός - [genetika tropopiimenos organismos]
γενετική - [genetiki]
γενετική βελτίωση - [genetiki beltiosi]
γενετική επίδραση - [genetiki epidrasi]
γενετική μηχανική - [genetiki mijaniki]
γενετική ομάδα - [genetiki omada]
γενετική πληροφορία - [genetiki pliroforia]
γενετική ποικιλία - [genetiki pikilia]
γενετική ποικιλότητα - [genetiki pikilotita]
γενετική τροποποίηση - [genetiki tropopiisi]
γενετική φυτων - [genetiki fiton]
γενετικοί πόροι - [genetiki pori]
γενιά - [genia]
γενικές υποθέσεις - [genikes ipozesis]
γενική απεργία - [geniki apergia]
γενική εκπαίδευση - [geniki ekpedefsi]
γενική χημεία - [geniki jimia]
γενικώς - [genikos]
γενοκτονία - [genoktonia]
γεράνι - [gerani]
γεράνιον - [geranion]
γερανός - [geranos]
γερμάνιο - [germanio]
γερμανικά - [germanika]
γερμανικά (αυστρία) - [germanika (afstria)]
γερμανικά (ελβετία) - [germanika (elbetia)]
γερμανικός - [germanikos]
γερουσιαστής - [gerusiastis]
γευματίζω - [gefmatiso]
γεωγονικός παράγοντας - [geogonikos paragodas]
γεωγραφία - [geografia]
γεωγραφική προβολή - [geografiki proboli]
γεωγραφικό μήκος - [geografiko mikos]
γεωγραφικό πλάτος - [geografiko platos]
γεωγραφικός κύκλος - [geografikos kiklos]
γεωδαισία - [geodesia]
γεωθερμική ενέργεια - [geozermiki energia]
γεωλογία - [geologia]
γεωλογία ορυχείων - [geologia orijion]
γεωλογία πετρελαίου - [geologia petreleu]
γεωμετρία - [geometria]
γεωμετρική διόρθωση - [geometriki diorzosi]
γεωμορφολογία - [geomorfologia]
γεωπολιτική - [geopolitiki]
γεωπονία - [geoponia]
γεωπονική - [geoponiki]
γεωργία - [georgia]
γεωργιανά - [georgiana]
γεωργικά μηχανήματα - [georgika mijanimata]
γεωργική βιομηχανία - [georgiki biomijania]
γεωργική διαχείριση - [georgiki diajirisi]
γεωργική μηχανική - [georgiki mijaniki]
γεωργική οικονομία - [georgiki ikonomia]
γεωργική παραγωγή - [georgiki paragogi]
γεωργική πολιτική - [georgiki politiki]
γεωργικός εξοπλισμός - [georgikos eksoplismos]
γεωργικός τομέας - [georgikos tomeas]
γεωργοβιομηχανία - [georgobiomijania]
γεωργοδασοκομία - [georgodasokomia]
γεωργοδασοπονία - [georgodasoponia]
γεωσκώληκες - [geoskolikes]
γεωτεχνική - [geotejniki]
γεωτεχνολογία - [geotejnologia]
γεωφυσική - [geofisiki]
γεωχημεία - [geojimia]
γεωχημικός - [geojimikos]
γεύμα - [gefma]
γεύομαι - [gefome]
γεύση - [gefsi]
γεύση του νερού - [gefsi tu neru]
γεώμηλο - [geomilo]
γεώτρηση - [geotrisi]
γη - [gi]
για λίγο - [gia ligo]
γιαγιά - [giagia]
γιαούρτι - [giaurti]
γιατί - [giati]
γιατρός - [giatros]
γιεν - [gien]
γιουνίπερος - [giuniperos]
γιωτ - [giot]
γκανέζικος - [gkanesikos]
γκιλοτίνα - [gkilotina]
γκολφ - [gkolf]
γκουτζαρατικά - [gkutsaratika]
γκρίζος - [gkrisos]
γκρι - [gkri]
γλάρος - [glaros]
γλαυκό - [glafko]
γλαύκα - [glafka]
γλαύκωμα - [glafkoma]
γλειφιτζούρι - [glifitsuri]
γλυκά ύδατα - [glika idata]
γλυκαντικό - [glikadiko]
γλυκοπατάτα - [glikopatata]
γλυκός - [glikos]
γλωσσάριο - [glosario]
γλωσσολογία - [glosologia]
γλωσσομαθής - [glosomazis]
γλύπτης - [gliptis]
γλώσσα - [glosa]
γναθοθύλακας - [gnazozilakas]
γνωμοδότηση - [gnomodotisi]
γνωρίζω - [gnoriso]
γνωσιολογία - [gnosiologia]
γνωστική ψυχολογία - [gnostiki psijologia]
γνωστοποίηση - [gnostopiisi]
γνώμη - [gnomi]
γνώση - [gnosi]
γοβα - [goba]
γοητευτικός - [goiteftikos]
γομολάστιχα - [gomolastija]
γονέας - [goneas]
γονίδιο - [gonidio]
γονιμότητα του εδάφους - [gonimotita tu edafus]
γονοτοξικότητα - [gonotoksikotita]
γονυκλισία - [goniklisia]
γορίλας - [gorilas]
γουανάμπανα - [guanabana]
γουδί - [gudi]
γουδοχέρι - [gudojeri]
γουνοδέρματα - [gunodermata]
γουνοφόρο ζώο - [gunoforo soo]
γουνόδερμα - [gunoderma]
γουρούνι - [guruni]
γουόκ - [guok]
γράμμα - [grama]
γράφω - [grafo]
γράψιμο - [grapsimo]
γρίβνα - [gribna]
γρίππη - [gripi]
γραβάτα - [grabata]
γραμμάριο - [gramario]
γραμμή - [grami]
γραμμή υψηλής τάσης - [grami ipsilis tasis]
γραμματέας - [gramateas]
γραμματική - [gramatiki]
γραμματόσημο - [gramatosimo]
γραμμική πηγή - [gramiki pigi]
γραμμική πηγή ήχου - [gramiki pigi iju]
γρασίδι - [grasidi]
γραφή - [grafi]
γραφείο - [grafio]
γραφειοκρατικοποίηση - [grafiokratikopiisi]
γραφικό περιβάλλον διασύνδεσης - [grafiko peribalon diasindesis]
γραφικός χαρακτήρας - [grafikos jaraktiras]
γραφομηχανή - [grafomijani]
γρύλος - [grilos]
γυαλί - [giali]
γυαλιά - [gialia]
γυαλιά ηλίου - [gialia iliu]
γυαλόχαρτο - [gialojarto]
γυμνάσιο - [gimnasio]
γυμναστική - [gimnastiki]
γυμνισμός - [gimnismos]
γυμνόσπερμα - [gimnosperma]
γυναίκα - [gineka]
γωνία - [gonia]
γόμα - [goma]
γόνατο - [gonato]
γόνος - [gonos]
γύμνια - [gimnia]
γύπας - [gipas]
γύρη - [giri]
γύψος - [gipsos]
δάγκωμα - [dagkoma]
δάκρυ - [dakri]
δάνειο - [danio]
δάπεδο - [dapedo]
δάσκαλος - [daskalos]
δάσος - [dasos]
δάσος βροχής - [dasos brojis]
δάσος κωνοφόρων - [dasos konoforon]
δάσος φυλλοβόλων - [dasos filobolon]
δάχτυλο - [dajtilo]
δέκα - [deka]
δέκατο - [dekato]
δέλτα - [delta]
δέντρο - [dedro]
δέος - [deos]
δέρμα - [derma]
δέσμευση αζώτου - [desmefsi asotu]
δήμαρχος - [dimarjos]
δήμευση - [dimefsi]
δήμος - [dimos]
δίαυλος - [diaflos]
δίδακτρα - [didaktra]
δίκαιο - [dikeo]
δίκαιο της εναερίου κυκλοφορίας - [dikeo tis enaeriu kikloforias]
δίκαιο του ανταγωνισμού - [dikeo tu adagonismu]
δίκη - [diki]
δίκοπος - [dikopos]
δίκτυο αερίου - [diktio aeriu]
δίκτυο βιοτόπων - [diktio biotopon]
δίκτυο ευρείας περιοχής - [diktio efrias periojis]
δίκτυο πληροφοριών - [diktio pliroforion]
δίνω - [dino]
δίοδος - [diodos]
δίπλωμα - [diploma]
δίπλωμα οδήγησης - [diploma odigisis]
δίποδο - [dipodo]
δίπτερα - [diptera]
δίχρονος κινητήρας - [dijronos kinitiras]
δίψα - [dipsa]
δίωξη - [dioksi]
δαγκώνω - [dagkono]
δακτυλίωση - [daktiliosi]
δακτυλικό αποτύπωμα - [daktiliko apotipoma]
δαμάσκηνο - [damaskino]
δανείζομαι - [danisome]
δανεισμός μεταξύ βιβλιοθηκών - [danismos metaksi bibliozikon]
δανικά - [danika]
δαπάνες - [dapanes]
δαπάνες νοικοκυριών - [dapanes nikokirion]
δαπάνη - [dapani]
δασική έκταση εύκρατης περιοχής - [dasiki ektasi efkratis periojis]
δασική οικολογία - [dasiki ikologia]
δασική πολιτική - [dasiki politiki]
δασική πυρκαγιά - [dasiki pirkagia]
δασικό οικοσύστημα - [dasiko ikosistima]
δασκάλα - [daskala]
δασμολόγιο - [dasmologio]
δασμός - [dasmos]
δασοκαταφύγιο - [dasokatafigio]
δασοκομία - [dasokomia]
δασοκομική πρακτική - [dasokomiki praktiki]
δασολογία - [dasologia]
δασοπονία - [dasoponia]
δασοπροστασία - [dasoprostasia]
δαχτυλίδι - [dajtilidi]
δαχτυλίθρα - [dajtilizra]
δείκτης - [diktis]
δεδομένο - [dedomeno]
δειγματοληψία - [digmatolipsia]
δεινός σκοπευτής - [dinos skopeftis]
δεκάξι - [dekaksi]
δεκαεννέα - [dekaenea]
δεκαεννιά - [dekaenia]
δεκαεπτά - [dekaepta]
δεκαετία - [dekaetia]
δεκανέας - [dekaneas]
δεκαοκτώ - [dekaokto]
δεκαπέντε - [dekapede]
δεκαπενθήμερο - [dekapenzimero]
δεκατέσσερα - [dekatesera]
δεκατέσσερις - [dekateseris]
δεκατοστόγραμμα - [dekatostograma]
δεκατρία - [dekatria]
δεκατρείς - [dekatris]
δεκοχτούρα - [dekojtura]
δελτίο αποστολής - [deltio apostolis]
δελτίο τύπου - [deltio tipu]
δελφίνι - [delfini]
δεματοποίηση - [dematopiisi]
δενδροκομία - [dendrokomia]
δενδροκομείο - [dendrokomio]
δενδρολίβανο - [dendrolibano]
δενδρομετρία - [dendrometria]
δενδροχρονολόγηση - [dendrojronologisi]
δεξαμενή - [deksameni]
δεξαμενή αερίου - [deksameni aeriu]
δεξαμενή ανύψωσης σε διώρυγα - [deksameni anipsosis se dioriga]
δεξαμενή καθιζήσεως - [deksameni kazisiseos]
δεξαμενή κατακράτησης - [deksameni katakratisis]
δεξαμενή σταθεροποίησης - [deksameni stazeropiisis]
δεξαμενή υγρών αποβλήτων - [deksameni igron apobliton]
δεξαμενόπλοιο - [deksamenoplio]
δεοντολογία - [deodologia]
δεοξυριβονουκλεϊκό οξύ - [deoksiribonukliko oksi]
δερματόπτερα - [dermatoptera]
δεσμωτήριο - [desmotirio]
δεσποινίδα - [despinida]
δευτερεύων βιότοπος - [defterefon biotopos]
δευτερεύων λογαριασμός - [defterefon logariasmos]
δευτεροβάθμια εκπαίδευση - [defterobazmia ekpedefsi]
δευτερογενής τομέας - [defterogenis tomeas]
δευτερόλεπτο - [defterolepto]
δεύτερο - [deftero]
δεύτερος - [defteros]
δηλητήριο - [dilitirio]
δηλητηρίαση - [dilitiriasi]
δηλητηριώδης - [dilitiriodis]
δημήτριο - [dimitrio]
δημαρχία - [dimarjia]
δημιουργικότητα - [dimiurgikotita]
δημιουργώ - [dimiurgo]
δημογραφία - [dimografia]
δημογραφική εξέλιξη - [dimografiki ekseliksi]
δημοκράτης - [dimokratis]
δημοκρατία - [dimokratia]
δημοκρατικά - [dimokratika]
δημοκρατική χώρα - [dimokratiki jora]
δημοκρατικό πολίτευμα - [dimokratiko politefma]
δημοκρατικός - [dimokratikos]
δημοσιογράφος - [dimosiografos]
δημοσιονομική πολιτική - [dimosionomiki politiki]
δημοτικό σχολείο - [dimotiko sjolio]
δημοψήφισμα - [dimopsifisma]
δημόσια δράση - [dimosia drasi]
δημόσια ερώτηση - [dimosia erotisi]
δημόσια λουτρά - [dimosia lutra]
δημόσια συγκοινωνία - [dimosia sigkinonia]
δημόσια υγεία - [dimosia igia]
δημόσια υπηρεσία - [dimosia ipiresia]
δημόσιες σχέσεις - [dimosies sjesis]
δημόσιο δίκαιο - [dimosio dikeo]
δημόσιο διεθνές δίκαιο - [dimosio dieznes dikeo]
δημόσιο κτήριο - [dimosio ktirio]
δημόσιο πάρκο - [dimosio parko]
δημόσιο χρέος - [dimosio jreos]
δημόσιος τομέας - [dimosios tomeas]
διάβρωση - [diabrosi]
διάβρωση της ακτής - [diabrosi tis aktis]
διάβρωση του εδάφους - [diabrosi tu edafus]
διάγραμμα - [diagrama]
διάδοση του ήχου - [diadosi tu iju]
διάδοχος - [diadojos]
διάδρομος χιονοδρομίας - [diadromos jionodromias]
διάθεση στην αγορά - [diazesi stin agora]
διάλειμμα - [dialima]
διάλεξη - [dialeksi]
διάλογος - [dialogos]
διάλυση - [dialisi]
διάμεσος - [diamesos]
διάνοια - [diania]
διάνυσμα - [dianisma]
διάρθρωση της αλιείας - [diarzrosi tis aliias]
διάρθρωση του πληθυσμού - [diarzrosi tu plizismu]
διάρκεια ηλιοφάνειας - [diarkia iliofanias]
διάρροια - [diaria]
διάρρους - [diarus]
διάστημα - [diastima]
διάταγμα - [diatagma]
διάταξη - [diataksi]
διάταξη εξάτμισης - [diataksi eksatmisis]
διάταξη θωράκισης - [diataksi zorakisis]
διάτομα - [diatoma]
διάτρηση - [diatrisi]
διάχυση - [diajisi]
διήγημα - [diigima]
διήθηση - [diizisi]
διήθηση εικόνας - [diizisi ikonas]
διαβάζω - [diabaso]
διαβίωση των ζώων - [diabiosi ton soon]
διαβατήριο - [diabatirio]
διαβούλευση - [diabulefsi]
διαβροχή - [diabroji]
διαγαλαξιακός - [diagalaksiakos]
διαγραμμισμός - [diagramismos]
διαγωνισμός - [diagonismos]
διαγώνιος - [diagonios]
διαδήλωση - [diadilosi]
διαδικασία θερμοεπιλογής - [diadikasia zermoepilogis]
διαδικασία λεύκανσης - [diadikasia lefkansis]
διαδρομή πεζοπορίας - [diadromi pesoporias]
διαζύγιο - [diasigio]
διαθέσιμος - [diazesimos]
διαθέσιμος χρόνος - [diazesimos jronos]
διαιρώ - [diero]
διαιτητής - [dietitis]
διακοπές - [diakopes]
διακοσμητικός - [diakosmitikos]
διακόσια - [diakosia]
διακόσμηση - [diakosmisi]
διαλειτουργικότητα - [dialiturgikotita]
διαλεκτικός υλισμός - [dialektikos ilismos]
διαλογή αποβλήτων - [dialogi apobliton]
διαλογισμός - [dialogismos]
διαλυμένος οργανικός άνθρακας - [dialimenos organikos anzrakas]
διαλυτότητα - [dialitotita]
διαλύτης - [dialitis]
διαμάντι - [diamadi]
διαμάχη - [diamaji]
διαμέρισμα - [diamerisma]
διαμαρτία διάπλασης - [diamartia diaplasis]
διαμόρφωση εδάφους - [diamorfosi edafus]
διαμόρφωση πρανών - [diamorfosi pranon]
διανομή - [dianomi]
διανομή νερού - [dianomi neru]
διαπίδυση - [diapidisi]
διαπερατότητα - [diaperatotita]
διαπνοή - [diapnoi]
διαποτισμός - [diapotismos]
διαρροή - [diaroi]
διασκορπισμός - [diaskorpismos]
διασπορά - [diaspora]
διαστασιοδότηση - [diastasiodotisi]
διασταύρωση - [diastafrosi]
διαστημικά απόβλητα - [diastimika apoblita]
διαστημική πολιτική - [diastimiki politiki]
διαστημικό ταξίδι - [diastimiko taksidi]
διαστρωμάτωση - [diastromatosi]
διατήρηση - [diatirisi]
διατήρηση ειδών - [diatirisi idon]
διατήρηση της ειρήνης - [diatirisi tis irinis]
διατήρηση της φύσης - [diatirisi tis fisis]
διατήρηση του τοπίου - [diatirisi tu topiu]
διαταγή - [diatagi]
διαταραχή του ύπνου - [diataraji tu ipnu]
διατριβή - [diatribi]
διατροφή - [diatrofi]
διαφήμιση - [diafimisi]
διαφήμιση προϊόντος - [diafimisi priodos]
διαφανές χρώμα - [diafanes jroma]
διαφορά - [diafora]
διαφοροποίηση - [diaforopiisi]
διαφυγή - [diafigi]
διαφωνία - [diafonia]
διαχείμαση - [diajimasi]
διαχείριση - [diajirisi]
διαχείριση αλυσίδας - [diajirisi alisidas]
διαχείριση αποθεμάτων - [diajirisi apozematon]
διαχείριση κινδύνων - [diajirisi kindinon]
διαχείριση κύκλου ζωής - [diajirisi kiklu sois]
διαχείριση ποταμού - [diajirisi potamu]
διαχείριση της ενέργειας - [diajirisi tis energias]
διαχείριση της ποιότητας των υδάτων - [diajirisi tis piotitas ton idaton]
διαχείριση της πόλης - [diajirisi tis polis]
διαχείριση των υδατικών πόρων - [diajirisi ton idatikon poron]
διαχωριστής - [diajoristis]
διαχωριστής ελαφρών υγρών - [diajoristis elafron igron]
διαχωριστής σωματιδίων - [diajoristis somatidion]
διαύγαση - [diafgasi]
διδάσκω - [didasko]
διδακτική - [didaktiki]
διδακτική μέθοδος - [didaktiki mezodos]
διδασκαλία - [didaskalia]
διδώ - [dido]
διεθνές δίκαιο - [dieznes dikeo]
διεθνές εμπόριο - [dieznes eborio]
διεθνές οικονομικό δίκαιο - [dieznes ikonomiko dikeo]
διεθνής ανταγωνιστικότητα - [dieznis adagonistikotita]
διεθνής ασφάλεια - [dieznis asfalia]
διεθνής εναρμόνιση - [dieznis enarmonisi]
διεθνής ισορροπία - [dieznis isoropia]
διεθνής οργανισμός - [dieznis organismos]
διεθνής συμφωνία - [dieznis simfonia]
διεθνής τυποποίηση - [dieznis tipopiisi]
διεκδικώ - [diekdiko]
διεπαφή προγραμματισμού εφαρμογών - [diepafi programatismu efarmogon]
διεπιστημονική έρευνα - [diepistimoniki erefna]
διεργαστηριακή σύγκριση - [diergastiriaki sigkrisi]
διερμηνέας - [diermineas]
διευθέτηση - [diefzetisi]
διευθυντής - [diefzidis]
διευκολύνω - [diefkolino]
διεύθυνση - [diefzinsi]
διηγούμαι - [diigume]
δικαίωμα - [dikeoma]
δικαίωμα αναφοράς - [dikeoma anaforas]
δικαίωμα πληροφόρησης - [dikeoma pliroforisis]
δικαίωμα προτίμησης - [dikeoma protimisis]
δικαιοδοσία - [dikeodosia]
δικαιοσύνη - [dikeosini]
δικαιώματα - [dikeomata]
δικαιώματα του πολίτη - [dikeomata tu politi]
δικαιώματα των ζώων - [dikeomata ton soon]
δικαστήριο - [dikastirio]
δικαστική αρωγή - [dikastiki arogi]
δικαστικό σύστημα - [dikastiko sistima]
δικαστικό σώμα - [dikastiko soma]
δικαστικός επιμελητής - [dikastikos epimelitis]
δικηγόρος - [dikigoros]
δικονομικό δίκαιο - [dikonomiko dikeo]
δικτάτορας - [diktatoras]
δικτατορία - [diktatoria]
διμερής σύμβαση - [dimeris simbasi]
διοίκηση - [diikisi]
διοικητική - [diikitiki]
διοικητική αρχή - [diikitiki arji]
διοικητική δικαιοδοσία - [diikitiki dikeodosia]
διοικητική κύρωση - [diikitiki kirosi]
διοικητική περιφέρεια - [diikitiki periferia]
διοικητική πράξη - [diikitiki praksi]
διοικητικό δίκαιο - [diikitiko dikeo]
διοικητικό διάταγμα - [diikitiko diatagma]
διοικητικό δικαστήριο - [diikitiko dikastirio]
διοικητικός φορέας - [diikitikos foreas]
διοξίδιο του άνθρακα - [dioksidio tu anzraka]
διοξίδιο του αζώτου - [dioksidio tu asotu]
διοξίδιο του θείου - [dioksidio tu ziu]
διοξίδιο του τιτανίου - [dioksidio tu titaniu]
διοξίνη - [dioksini]
διορία - [dioria]
διορίζω - [dioriso]
διπλοσάινο - [diploseno]
δισεκατομμυριούχος - [disekatomiriujos]
δισεκατομμύριο - [disekatomirio]
δισκογραφία - [diskografia]
δισκοθήκη - [diskoziki]
διστάζω - [distaso]
διυλιστήρια - [diilistiria]
διυλιστήριο - [diilistirio]
διυλιστήριο πετρελαίου - [diilistirio petreleu]
διφθερίτις - [difzeritis]
διχλωροδιφαινυλτριχλωροαιθάνιο - [dijlorodifeniltrijloroezanio]
διψάω - [dipsao]
διψασμένος - [dipsasmenos]
διύλιση - [diilisi]
διύλιση πετρελαίου - [diilisi petreleu]
διώρυγα - [dioriga]
δοδώ - [dodo]
δοθιήνας - [doziinas]
δοκάρι - [dokari]
δοκιμάζω - [dokimaso]
δοκιμή - [dokimi]
δοκιμασία - [dokimasia]
δοκιμασία κατά ames - [dokimasia kata ames]
δοκιμαστικός σωλήνας - [dokimastikos solinas]
δολλάριο - [dolario]
δολοφονία - [dolofonia]
δολοφονώ - [dolofono]
δολοφόνος - [dolofonos]
δομή της απασχόλησης - [domi tis apasjolisis]
δομημένη περιοχή - [domimeni perioji]
δομημένο περιβάλλον - [domimeno peribalon]
δομικό στοιχείο - [domiko stijio]
δορυφορική εικόνα - [doriforiki ikona]
δορυφόρος - [doriforos]
δορυφόρος παρατηρήσεων - [doriforos paratiriseon]
δοσολογία - [dosologia]
δοσομέτρηση - [dosometrisi]
δοτική - [dotiki]
δουλεία - [dulia]
δουλεύω - [dulefo]
δοχείο ψεκασμού - [dojio psekasmu]
δούλος - [dulos]
δράκος - [drakos]
δραστηριότητα του ανθρώπου - [drastiriotita tu anzropu]
δρομάς - [dromas]
δρυς - [dris]
δρόμος - [dromos]
δυαδική οικονομία - [diadiki ikonomia]
δυναμικό καταστροφής του όζοντος - [dinamiko katastrofis tu osodos]
δυναμικός - [dinamikos]
δυο - [dio]
δυσλεξία - [disleksia]
δυσμορφία - [dismorfia]
δυσπλασία - [displasia]
δυσπρόσιο - [disprosio]
δυστυχώς - [distijos]
δυό φορές - [dio fores]
δυόσμος - [diosmos]
δωδεκαδάκτυλο - [dodekadaktilo]
δωμάτιο - [domatio]
δωρίζω - [doriso]
δωρεά - [dorea]
δωροδοκία - [dorodokia]
δωροδοκώ - [dorodoko]
δωροληψία - [dorolipsia]
δωσιδικία - [dosidikia]
δόγμα - [dogma]
δόντι - [dodi]
δόση - [dosi]
δόση ακτινοβολίας - [dosi aktinobolias]
δύναμη αποτροπής - [dinami apotropis]
δύναμη όπλο αποτροπής - [dinami oplo apotropis]
δύο - [dio]
δύο χιλιάδες - [dio jiliades]
δύση - [disi]
δύσκολος-η-ο - [diskolos-i-o]
δώδεκα - [dodeka]
δώρο - [doro]
είδη επιπλώσεων - [idi epiploseon]
είδος - [idos]
είδος αξίωσης - [idos aksiosis]
είδος βλάστησης - [idos blastisis]
είδος δουλείας - [idos dulias]
είκοσι - [ikosi]
είκοσι ένα - [ikosi ena]
είκοσι έξι - [ikosi eksi]
είκοσι δύο - [ikosi dio]
είκοσι εννέα - [ikosi enea]
είκοσι εφτά - [ikosi efta]
είκοσι πέντε - [ikosi pede]
είκοσι τέσσερα - [ikosi tesera]
είκοσι τρείς - [ikosi tris]
είκοσι-οκτώ - [ikosi-okto]
είσπραξη φόρου - [ispraksi foru]
εβδομάδα - [ebdomada]
εβδομήντα επτά - [ebdomida epta]
εβραϊκά - [ebreka]
εγγραφή - [egrafi]
εγγύηση - [egiisi]
εγγύηση αποζημίωσης - [egiisi aposimiosis]
εγκαίνια - [egkenia]
εγκατάσταση κοινωνικής πρόνοιας - [egkatastasi kinonikis pronias]
εγκαταλειμμένος βιομηχανικός χώρος - [egkatalimenos biomijanikos joros]
εγκαταλελειμμένο όχημα - [egkatalelimeno ojima]
εγκεφαλικό στέλεγχος - [egkefaliko stelegjos]
εγκεφαλοπάθεια - [egkefalopazia]
εγκληματικότητα - [egklimatikotita]
εγκληματικότητα εις βάρος του περιβάλλοντος - [egklimatikotita is baros tu peribalodos]
εγκληματολογία - [egklimatologia]
εγκληματολόγος - [egklimatologos]
εγκλωβισμός - [egklobismos]
εγκυκλοπαίδεια - [egkiklopedia]
εγκυμοσύνη - [egkimosini]
εγχείρηση - [egjirisi]
εγχώρια γνώση - [egjoria gnosi]
εγώ - [ego]
εδαφική στρώση - [edafiki strosi]
εδαφικό ύδωρ - [edafiko idor]
εδαφικός ορίζοντας - [edafikos orisodas]
εδαφοβιολογία - [edafobiologia]
εδαφογένεση - [edafogenesi]
εδαφοκατατομή - [edafokatatomi]
εδαφολογία - [edafologia]
εδαφολογικές συνθήκες - [edafologikes sinzikes]
εδαφομηχανική - [edafomijaniki]
εθελοντικά - [ezelodika]
εθελοντική εργασία - [ezelodiki ergasia]
εθνική νομοθεσία - [ezniki nomozesia]
εθνικισμος - [eznikismos]
εθνικοποίηση - [eznikopiisi]
εθνικοσοσιαλισμός - [eznikososialismos]
εθνικοσοσιαλιστής - [eznikososialistis]
εθνικό πάρκο - [ezniko parko]
εθνογραφία - [eznografia]
εθνοκάθαρση - [eznokazarsi]
εθνολογία - [eznologia]
ειδικά απόβλητα - [idika apoblita]
ειδική άδεια - [idiki adia]
ειδικευμένη εργασία - [idikefmeni ergasia]
ειδικός νόμος - [idikos nomos]
ειδοποίηση - [idopiisi]
εικονοκλάστης - [ikonoklastis]
εικόνα - [ikona]
ειλεός - [ileos]
ειρηνιστής - [irinistis]
ειρωνεία - [ironia]
εισάγω - [isago]
εισαγωγή - [isagogi]
εισιτήριο - [isitirio]
εισπράκτορας - [ispraktoras]
εισφορά - [isfora]
εισόδημα - [isodima]
εκατομμυριούχος - [ekatomiriujos]
εκατονταετία - [ekatodaetia]
εκατονταετηρίδα - [ekatodaetirida]
εκατοστό - [ekatosto]
εκατοστόμετρο - [ekatostometro]
εκατόν - [ekaton]
εκβιομηχάνιση - [ekbiomijanisi]
εκβολή ποταμού - [ekboli potamu]
εκδίδομαι - [ekdidome]
εκδικούμαι - [ekdikume]
εκδρομή - [ekdromi]
εκεί - [eki]
εκθάμνωση - [ekzamnosi]
εκκεντρότητα - [ekkedrotita]
εκκενώσει - [ekkenosi]
εκκλησία - [ekklisia]
εκλεκτός - [eklektos]
εκλογή - [eklogi]
εκμίσθωση - [ekmiszosi]
εκμετάλλευση πόρου - [ekmetalefsi poru]
εκπαίδευση - [ekpedefsi]
εκπαίδευση ενηλίκων - [ekpedefsi enilikon]
εκπαιδευτική κατεύθυνση - [ekpedeftiki katefzinsi]
εκπαιδευτική πολιτική - [ekpedeftiki politiki]
εκπαιδευτικό ίδρυμα - [ekpedeftiko idrima]
εκπαιδευτικό σύστημα - [ekpedeftiko sistima]
εκπαιδευτικός προγραμματισμός - [ekpedeftikos programatismos]
εκπλήσσω - [ekpliso]
εκπομπή - [ekpobi]
εκπομπή ήχου - [ekpobi iju]
εκπομπή θορύβου - [ekpobi zoribu]
εκπομπή ρύπων - [ekpobi ripon]
εκπορνεύομαι - [ekpornefome]
εκπώμαστρο - [ekpomastro]
εκρίζωση - [ekrisosi]
εκρόφηση - [ekrofisi]
εκσκαφή - [ekskafi]
εκσκαφείσα οπή - [ekskafisa opi]
εκτάσεις σε αγρανάπαυση - [ektasis se agranapafsi]
εκτίμηση - [ektimisi]
εκτίμηση του περιβαλλοντικού κινδύνου - [ektimisi tu peribalodiku kindinu]
εκτατική κτηνοτροφία - [ektatiki ktinotrofia]
εκτελεστικό διάταγμα - [ektelestiko diatagma]
εκτιμώ - [ektimo]
εκτροφή ζώων - [ektrofi soon]
εκτυπωτής - [ektipotis]
εκχέρσωση - [ekjersosi]
εκχείλιση - [ekjilisi]
εκχύλιση - [ekjilisi]
εκχώρηση - [ekjorisi]
ελάττωμα - [elatoma]
ελέφαντας - [elefadas]
ελαία - [elea]
ελαιοκράμβη - [eleokrambi]
ελαιόδενδρο - [eleodendro]
ελαιόλαδο - [eleolado]
ελαστικό - [elastiko]
ελαστικό αυτοκινήτου - [elastiko aftokinitu]
ελαστικότητα - [elastikotita]
ελατήριο - [elatirio]
ελαφίδες - [elafides]
ελαφίνα - [elafina]
ελεγκτική αρχή - [elegktiki arji]
ελεγχόμενη καύση - [elegjomeni kafsi]
ελευθερία - [elefzeria]
ελεφαντοστό - [elefadosto]
ελεφαντόδοντο - [elefadododo]
ελεύθερες συναλλαγές - [elefzeres sinalages]
ελεύθερο εμπόριο - [elefzero eborio]
ελεύθερος χρόνος - [elefzeros jronos]
ελιά - [elia]
ελικοδρόμιο - [elikodromio]
ελικόπτερο - [elikoptero]
ελκυστικός - [elkistikos]
ελκύω - [elkio]
ελληνικά - [elinika]
ελληνική - [eliniki]
ελληνικός - [elinikos]
ελονοσία - [elonosia]
εμβάπτιση - [embaptisi]
εμβρυογένεση - [embriogenesi]
εμβόλιο - [embolio]
εμείς - [emis]
εμετικό - [emetiko]
εμμηνορροώ - [eminoroo]
εμμονή - [emoni]
εμπλοκέας - [eblokeas]
εμπλουτισμένο ουράνιο - [eblutismeno uranio]
εμπλουτισμός - [eblutismos]
εμπορία - [eboria]
εμπορία φυτών - [eboria fiton]
εμπορευματικές μεταφορές - [eborefmatikes metafores]
εμπορευματική κίνηση - [eborefmatiki kinisi]
εμπορευματοποίηση - [eborefmatopiisi]
εμπορεύματα - [eborefmata]
εμπορική δραστηριότητα - [eboriki drastiriotita]
εμπορική ναυτιλία - [eboriki naftilia]
εμπορική πολιτική - [eboriki politiki]
εμπορική συναλλαγή - [eboriki sinalagi]
εμπορικό δίκαιο - [eboriko dikeo]
εμπορικό κέντρο - [eboriko kedro]
εμπορικός φραγμός - [eborikos fragmos]
εμποτισμός - [ebotismos]
εμπρησμός - [ebrismos]
εμπόδιο - [ebodio]
εμπόριο - [eborio]
ενέργεια - [energia]
ενήλικος - [enilikos]
ενίσχυση αναχώματος - [enisjisi anajomatos]
εναέρια κυκλοφορία - [enaeria kikloforia]
εναέρια κυκλοφορία πολιτικής αεροπορίας - [enaeria kikloforia politikis aeroporias]
εναλλακτική τεχνολογία - [enalaktiki tejnologia]
εναρμόνιση της νομοθεσίας - [enarmonisi tis nomozesias]
ενδεχομένως - [endejomenos]
ενδημική φτώχεια - [endimiki ftojia]
ενδημικό είδος - [endimiko idos]
ενδιάμεσο προϊόν - [endiameso prion]
ενδιαίτημα - [endietima]
ενδιαφέρον - [endiaferon]
ενδιαφέρων - [endiaferon]
ενδοκαρδίτιδα - [endokarditida]
ενδοκρινολογία - [endokrinologia]
ενδοκτηριακό περιβάλλον - [endoktiriako peribalon]
ενδοοικογενειακή βία - [endoikogeniaki bia]
ενδυμασία - [endimasia]
ενδύματα - [endimata]
ενδύω - [endio]
ενενήντα εννέα - [enenida enea]
ενεργειακή πολιτική - [energiaki politiki]
ενεργειακή τεχνολογία - [energiaki tejnologia]
ενεργειακοί πόροι - [energiaki pori]
ενεργειακό ισοζύγιο - [energiako isosigio]
ενεργοποιημένη ιλύς - [energopiimeni ilis]
ενεργός άνθρακας - [energos anzrakas]
ενεργός πληθυσμός - [energos plizismos]
ενημέρωση - [enimerosi]
ενημερωτικό δελτίο - [enimerotiko deltio]
ενθουσιασμένος - [enzusiasmenos]
εννέα - [enea]
εννιά - [enia]
ενοίκιο - [enikio]
ενοικιαστής - [enikiastis]
ενοχή - [enoji]
ενσωμάτωση - [ensomatosi]
εντάσσω - [edaso]
εντατική καλλιέργεια - [edatiki kaliergia]
εντεροϊός - [ederios]
εντολή - [edoli]
εντομοκτόνο - [edomoktono]
εντομοφάγα - [edomofaga]
εντομοφάγος - [edomofagos]
εντοπισμός - [edopismos]
ενυδρίδα - [enidrida]
ενυδρείο - [enidrio]
ενωτίκευση - [enotikefsi]
ενωτικό - [enotiko]
ενύπνιον - [enipnion]
εξάνθημα - [eksanzima]
εξάντληση - [eksadlisi]
εξάτμιση - [eksatmisi]
εξέλιξη - [ekseliksi]
εξέταση - [eksetasi]
εξέταστρα - [eksetastra]
εξήγηση - [eksigisi]
εξήντα - [eksida]
εξήντα έξ - [eksida eks]
εξήντα εννέα - [eksida enea]
εξίσωση - [eksisosi]
εξαγωγή - [eksagogi]
εξαγωγή φυσικού αερίου - [eksagogi fisiku aeriu]
εξαερισμός - [eksaerismos]
εξαθλίωση - [eksazliosi]
εξακριβώνω - [eksakribono]
εξαντλημένος - [eksadlimenos]
εξαρτήματα - [eksartimata]
εξασθενίζω - [eksaszeniso]
εξασφάλιση πρώτης ύλης - [eksasfalisi protis ilis]
εξαφάνιση - [eksafanisi]
εξαφανίζομαι - [eksafanisome]
εξειδίκευση - [eksidikefsi]
εξευγενισμός - [eksefgenismos]
εξηγήσει - [eksigisi]
εξηγώ - [eksigo]
εξημερωμένο ζώο - [eksimeromeno soo]
εξιδρώνω - [eksidrono]
εξοικονόμηση - [eksikonomisi]
εξοικονόμηση ενέργειας - [eksikonomisi energias]
εξοικονόμηση νερού - [eksikonomisi neru]
εξομολογητήριο - [eksomologitirio]
εξοπλισμός - [eksoplismos]
εξορίζω - [eksoriso]
εξορυκτική βιομηχανία - [eksoriktiki biomijania]
εξουδετέρωση - [eksudeterosi]
εξουσιοδότηση - [eksusiodotisi]
εξυπηρέτηση κτηρίων - [eksipiretisi ktirion]
εξωπλανήτης - [eksoplanitis]
εξωραϊσμός - [eksoresmos]
εξωτερική πολιτική - [eksoteriki politiki]
εξωτερικό εμπόριο - [eksoteriko eborio]
εξωτερικότητα - [eksoterikotita]
εξόρυξη - [eksoriksi]
εξόρυξη άνθρακα - [eksoriksi anzraka]
εξόρυξη αδρανών υλικών - [eksoriksi adranon ilikon]
εξόρυξη αλατιού - [eksoriksi alatiu]
εξόρυξη ανοικτής θαλάσσης - [eksoriksi aniktis zalasis]
εξόρυξη λιγνίτη - [eksoriksi ligniti]
εξώστης - [eksostis]
εορτή - [eorti]
επάγγελμα - [epagelma]
επάγγελμα υγείας - [epagelma igias]
επένδυση - [ependisi]
επένθημα - [epenzima]
επί τούτω - [epi tuto]
επί τόπου - [epi topu]
επίγραμμα - [epigrama]
επίδειξη - [epidiksi]
επίδομα - [epidoma]
επίδραση συνδυασμού - [epidrasi sindiasmu]
επίδραση του φαινομένου του θερμοκηπίου - [epidrasi tu fenomenu tu zermokipiu]
επίθετο - [epizeto]
επίκεντρο - [epikedro]
επίλεκτος σκοπευτής - [epilektos skopeftis]
επίπεδη μπαταρία - [epipedi bataria]
επίπεδο - [epipedo]
επίπεδο δημοτικής αρχής - [epipedo dimotikis arjis]
επίπεδο εκπαίδευσης - [epipedo ekpedefsis]
επίπεδο μολύβδου στο αίμα - [epipedo molibdu sto ema]
επίπλευση - [epiplefsi]
επίπλωση - [epiplosi]
επίρρημα - [epirima]
επίσημη ακρόαση - [episimi akroasi]
επίσημη αναγνώριση του κοινωφελούς χαρακτήρα - [episimi anagnorisi tu kinofelus jaraktira]
επίσημη γλώσσα - [episimi glosa]
επίσκοπος - [episkopos]
επίστρωση - [epistrosi]
επίσωτρο - [episotro]
επίχρισμα - [epijrisma]
επαγγελαμτική ένωση - [epagelamtiki enosi]
επαγγελματίας - [epagelmatias]
επαγγελματική ασθένεια - [epagelmatiki aszenia]
επαγγελματική δραστηριότητα - [epagelmatiki drastiriotita]
επαγγελματική ιατρική - [epagelmatiki iatriki]
επαγγελματική κατάρτιση - [epagelmatiki katartisi]
επαγγελματικός - [epagelmatikos]
επαναπαύομαι στις δάφνες μου - [epanapafome stis dafnes mu]
επαναρρόφηση - [epanarofisi]
επαναστέγαση - [epanastegasi]
επανασχηματισμός - [epanasjimatismos]
επαναφορά - [epanafora]
επαναχρησιμοποιούμενος περιέκτης - [epanajrisimopiumenos periektis]
επανεμφάνιση - [epanemfanisi]
επανεπεξεργασία - [epanepeksergasia]
επαρχία - [eparjia]
επενδυτής - [ependitis]
επεξεργασία δεδομένων - [epeksergasia dedomenon]
επεξεργασία εικόνας - [epeksergasia ikonas]
επεξεργασία πόσιμων υδάτων - [epeksergasia posimon idaton]
επεξεργασία της συγκομιδής - [epeksergasia tis sigkomidis]
επεξεργασία των υδάτων - [epeksergasia ton idaton]
επεξεργαστής κειμένου - [epeksergastis kimenu]
επιβίωση - [epibiosi]
επιβατικό αυτοκίνητο - [epibatiko aftokinito]
επιβλέπω - [epiblepo]
επιβλαβή ζώα - [epiblabi soa]
επιβολή του νόμου - [epiboli tu nomu]
επιβράδυνση - [epibradinsi]
επιγονατίδα - [epigonatida]
επιδερμίδα - [epidermida]
επιδημία - [epidimia]
επιδημιολογία - [epidimiologia]
επιδημιολόγος - [epidimiologos]
επιδότηση - [epidotisi]
επιζωοτία - [episootia]
επιθετικός - [epizetikos]
επιθεωρώ - [epizeoro]
επιθεώρηση - [epizeorisi]
επικάλυψη - [epikalipsi]
επικίνδυνο εμπόρευμα - [epikindino eborefma]
επικαρπία - [epikarpia]
επικείμενος - [epikimenos]
επικινδυνότητα - [epikindinotita]
επικοινωνίες - [epikinonies]
επικοινωνώ - [epikinono]
επικουρική αρχή - [epikuriki arji]
επικράτεια - [epikratia]
επιλαμβάνομαι - [epilambanome]
επιληπτικός - [epiliptikos]
επιμονή - [epimoni]
επιπτώσεις - [epiptosis]
επιπτώσεις στο περιβάλλον - [epiptosis sto peribalon]
επιπτώσεις της ακτινοβολίας - [epiptosis tis aktinobolias]
επισκευή εγκατάστασης - [episkefi egkatastasis]
επισκοπή - [episkopi]
επιστήμες της ατμόσφαιρας - [epistimes tis atmosferas]
επιστήμες της γης - [epistimes tis gis]
επιστήμες των υδάτων - [epistimes ton idaton]
επιστήμη - [epistimi]
επιστήμη του περιβάλλοντος - [epistimi tu peribalodos]
επιστήμη των τροφίμων - [epistimi ton trofimon]
επιστήμη των υλικών - [epistimi ton ilikon]
επιστημονική έρευνα - [epistimoniki erefna]
επιστημονική επιτροπή - [epistimoniki epitropi]
επιστολή - [epistoli]
επιστολόχαρτο - [epistolojarto]
επιστράτευση - [epistratefsi]
επιστρέφω - [epistrefo]
επιστρεφόμενο δοχείο - [epistrefomeno dojio]
επιτήδειος - [epitidios]
επιτήδευμα - [epitidefma]
επιταχυντής σωματιδίων - [epitajidis somatidion]
επιτιθέμενος - [epitizemenos]
επιτραπέζιος υπολογιστής - [epitrapesios ipologistis]
επιτρεπτό όριο έκθεσης - [epitrepto orio ekzesis]
επιτόπιος - [epitopios]
επιφάνεια - [epifania]
επιφάνεια κοπής - [epifania kopis]
επιφανειακά ύδατα - [epifaniaka idata]
επιφανειακή απορροή - [epifaniaki aporoi]
επιφανειακή εξόρυξη - [epifaniaki eksoriksi]
επιφανειακή τάση - [epifaniaki tasi]
επιχείρηση - [epijirisi]
επιχείρηση μη φιλική για το περιβάλλον - [epijirisi mi filiki gia to peribalon]
επιχειρήσεις - [epijirisis]
επιχειρήσεις βαφής - [epijirisis bafis]
επιχειρηματίας - [epijirimatias]
επιχορήγηση - [epijorigisi]
εποπτεία - [epoptia]
εποχή - [epoji]
εποχιακή διακύμανση - [epojiaki diakimansi]
επτά - [epta]
ερασιτέχνης - [erasitejnis]
ερασιτεχνική αλιεία - [erasitejniki aliia]
εργαλειοθήκη - [ergalioziki]
εργασία - [ergasia]
εργασία νέων - [ergasia neon]
εργαστήριο - [ergastirio]
εργαστήριο gis - [ergastirio gis]
εργαστηριακή έρευνα - [ergastiriaki erefna]
εργαστηριακή δοκιμή - [ergastiriaki dokimi]
εργαστηριακή τεχνική - [ergastiriaki tejniki]
εργαστηριακό πείραμα - [ergastiriako pirama]
εργατικό ατύχημα - [ergatiko atijima]
εργατικό δίκαιο - [ergatiko dikeo]
εργατικό δυναμικό - [ergatiko dinamiko]
εργατικό σωματείο - [ergatiko somatio]
εργοθεραπεία - [ergozerapia]
εργονομία - [ergonomia]
εργοστάσιο - [ergostasio]
εργοστάσιο χημικών - [ergostasio jimikon]
εργοτάξιο - [ergotaksio]
εργοτάξιο κατασκευών - [ergotaksio kataskefon]
ερείπιο - [eripio]
ερευνητικό σχέδιο - [erefnitiko sjedio]
ερημικό κλίμα - [erimiko klima]
ερμηνεύω - [erminefo]
ερπετά - [erpeta]
ερυθρό - [erizro]
ερωτομανία - [erotomania]
ερώτηση - [erotisi]
εσείς - [esis]
εσθονική - [eszoniki]
εσπεράντο - [esperado]
εστιατόριο - [estiatorio]
εσωτερικά ύδατα - [esoterika idata]
εσωτερικές πλωτές μεταφορές - [esoterikes plotes metafores]
εσωτερική μετανάστευση - [esoteriki metanastefsi]
εσωτερική ναυσιπλοΐα - [esoteriki nafsiploΐa]
εσωτερικοποίηση του εξωτερικού κόστους - [esoterikopiisi tu eksoteriku kostus]
εσωτερικό εμπόριο - [esoteriko eborio]
εσωτερικός - [esoterikos]
εσύ - [esi]
εσώρουχο - [esorujo]
εσώρρουχα - [esoruja]
εταιρεία διανομής αερίου - [eteria dianomis aeriu]
εταλλικό οξείδιο - [etaliko oksidio]
ετεροίωση - [eteriosi]
ετεροκυκλική ένωση - [eterokikliki enosi]
ετοιμότητα για την αντιμετώπιση καταστροφής - [etimotita gia tin adimetopisi katastrofis]
ετυμολογία - [etimologia]
ευάλωτο είδος - [efaloto idos]
ευγενικός - [efgenikos]
ευγνωμονώ - [efgnomono]
ευημερία - [efimeria]
ευθανασία - [efzanasia]
ευθυγράμμιση - [efzigramisi]
ευθύνη - [efzini]
ευθύνη για το προϊόν - [efzini gia to prion]
ευθύνη του παραγωγού - [efzini tu paragogu]
ευκάλυπτος - [efkaliptos]
ευκοιλιότητα - [efkiliotita]
ευοίωνος - [efionos]
ευπρέπεια - [efprepia]
ευπρεπής - [efprepis]
ευρετήριο - [efretirio]
ευρωκεντρισμός - [efrokedrismos]
ευρύς - [efris]
ευρώ - [efro]
ευσεβής - [efsebis]
ευφλεκτικότητα - [eflektikotita]
ευφορία - [eforia]
ευχαριστήρια - [efjaristiria]
ευχαριστημένος - [efjaristimenos]
ευχαριστώ - [efjaristo]
ευχαριστώ πολύ - [efjaristo poli]
ευχρηστία - [efjristia]
εφαρμοσμένες επιστήμες - [efarmosmenes epistimes]
εφαρμοσμένη έρευνα - [efarmosmeni erefna]
εφαρμοσμένη οικολογία - [efarmosmeni ikologia]
εφεξής - [efeksis]
εφημερίδα - [efimerida]
εφιάλτης - [efialtis]
εφιαλτικός - [efialtikos]
εφοδιασμός - [efodiasmos]
εφτά - [efta]
εφυάλωση - [efialosi]
εχθές - [ejzes]
εχθρός gr - [ejzros gr]
εχινόδερμα - [ejinoderma]
εύγευστος - [efgefstos]
εύκολο - [efkolo]
εύκρατο δάσος - [efkrato dasos]
εύκρατο κλίμα - [efkrato klima]
εύνοια - [efnia]
εύπορος - [efporos]
εύφλεκτη ουσία - [eflekti usia]
ζάχαρη - [sajari]
ζάχαρι - [sajari]
ζέβρα - [sebra]
ζέβρος - [sebros]
ζήτηση - [sitisi]
ζήτηση ενέργειας - [sitisi energias]
ζαλισμένος - [salismenos]
ζαμπόν - [sabon]
ζαρζαβατικό - [sarsabatiko]
ζαρκάδι - [sarkadi]
ζαφείρι - [safiri]
ζεστό νερό - [sesto nero]
ζημία - [simia]
ζητώ - [sito]
ζιζάνιο - [sisanio]
ζιζανιοκτόνο - [sisanioktono]
ζιρκόνιο - [sirkonio]
ζουλού - [sulu]
ζούγκλα - [sugkla]
ζυγός - [sigos]
ζω - [so]
ζωγραφίζω - [sografiso]
ζωεμπορία - [soeboria]
ζωική γενετική - [soiki genetiki]
ζωική υφαντική ίνα - [soiki ifadiki ina]
ζωικό κεφάλαιο - [soiko kefaleo]
ζωικός πληθυσμός - [soikos plizismos]
ζωντανά - [sodana]
ζωοβιολογία - [soobiologia]
ζωολογία - [soologia]
ζωολογικός κήπος - [soologikos kipos]
ζωονοσία - [soonosia]
ζωονόσος - [soonosos]
ζωοοικολογία - [sooikologia]
ζωοτεχνία - [sootejnia]
ζωοτροφή - [sootrofi]
ζωοφυσιολογία - [soofisiologia]
ζόμπι - [sobi]
ζύθος - [sizos]
ζύμωση - [simosi]
ζώα - [soa]
ζώνη - [soni]
ζώνη ασφαλείας - [soni asfalias]
ζώνη κυκλοφορίας πεζών - [soni kikloforias peson]
ζώνη πρασίνου - [soni prasinu]
ζώνη ώρας - [soni oras]
ζώο - [soo]
ζώο ανθεκτικό στην ξηρασία - [soo anzektiko stin ksirasia]
ζώο προς σφαγή - [soo pros sfagi]
η - [i]
ηγεμονία - [igemonia]
ηγουμένη - [igumeni]
ηδονοβλεψία - [idonoblepsia]
ηθική - [iziki]
ηθμός - [izmos]
ηθολογία - [izologia]
ηθολογικός - [izologikos]
ηθοποιός - [izopios]
ηλίανθος - [ilianzos]
ηλεκτρική ισχύς - [ilektriki isjis]
ηλεκτρική λάμπα - [ilektriki laba]
ηλεκτρική λυχνία - [ilektriki lijnia]
ηλεκτρική σκούπα - [ilektriki skupa]
ηλεκτρική στήλη - [ilektriki stili]
ηλεκτρικό φορτίο - [ilektriko fortio]
ηλεκτρικό όχημα - [ilektriko ojima]
ηλεκτρισμός - [ilektrismos]
ηλεκτροαιθαλομίχλη - [ilektroezalomijli]
ηλεκτροκινητική - [ilektrokinitiki]
ηλεκτρολύτης - [ilektrolitis]
ηλεκτρομηχανικός - [ilektromijanikos]
ηλεκτρονικό παιχνίδι - [ilektroniko pejnidi]
ηλεκτρονικό ταχυδρομείο - [ilektroniko tajidromio]
ηλεκτρόλυση - [ilektrolisi]
ηλεκτρόνιο - [ilektronio]
ηλιακή ακτινοβολία - [iliaki aktinobolia]
ηλιακή ενέργεια - [iliaki energia]
ηλιακή θέρμανση - [iliaki zermansi]
ηλιακό κύτταρο - [iliako kitaro]
ηλιακός - [iliakos]
ηλιακός συλλέκτης - [iliakos silektis]
ηλικία - [ilikia]
ημίρρευστη κοπριά - [imirefsti kopria]
ημερήσια επιτρεπόμενη δόση - [imerisia epitrepomeni dosi]
ημερολογιο - [imerologio]
ημερολόγιο - [imerologio]
ημερομηνία - [imerominia]
ημιαγωγός - [imiagogos]
ημικατεργασμένο προϊόν - [imikatergasmeno prion]
ημικρανία - [imikrania]
ημιμέταλλο - [imimetalo]
ημιπερατός - [imiperatos]
ηπειρωτική χώρα - [ipirotiki jora]
ηπειρωτικό κλίμα - [ipirotiko klima]
ηρωίνη - [iroini]
ηττοπάθεια - [itopazia]
ηφαίστειο - [ifestio]
ηφαιστειακή έκρηξη - [ifestiaki ekriksi]
ηφαιστειολογία - [ifestiologia]
ηφαιστειολόγος - [ifestiologos]
ηφαιστειότητα - [ifestiotita]
ηχητική όχληση - [ijitiki ojlisi]
ηχητικός ρύπος - [ijitikos ripos]
ηχομονωτικό υλικό - [ijomonotiko iliko]
ηχομόνωση - [ijomonosi]
ηχοπέτασμα - [ijopetasma]
ηχορύπανση - [ijoripansi]
ηχόχρωμα - [ijojroma]
θάλαμος - [zalamos]
θάλασσα - [zalasa]
θάλασσα wadden - [zalasa wadden]
θάλλιο - [zalio]
θάμνος - [zamnos]
θάνατος - [zanatos]
θέαμα - [zeama]
θέατρο - [zeatro]
θέλω - [zelo]
θέμα - [zema]
θέρμανση - [zermansi]
θέση - [zesi]
θέση των γυναικών - [zesi ton ginekon]
θήρευση - [zirefsi]
θίνα - [zina]
θαλάσσια αλιεία - [zalasia aliia]
θαλάσσια βιολογία - [zalasia biologia]
θαλάσσια γεωλογία - [zalasia geologia]
θαλάσσια θερμοκρασία - [zalasia zermokrasia]
θαλάσσια κυκλοφορία - [zalasia kikloforia]
θαλάσσια ναυσιπλοΐα - [zalasia nafsiploΐa]
θαλάσσια οικολογία - [zalasia ikologia]
θαλάσσια πανίδα - [zalasia panida]
θαλάσσια ρύπανση - [zalasia ripansi]
θαλάσσια ύδατα - [zalasia idata]
θαλάσσιο ίζημα - [zalasio isima]
θαλάσσιο θηλαστικό - [zalasio zilastiko]
θαλάσσιο καταφύγιο - [zalasio katafigio]
θαλάσσιο κύμα - [zalasio kima]
θαλάσσιο οικοσύστημα - [zalasio ikosistima]
θαλάσσιο πάρκο - [zalasio parko]
θαλάσσιο περιβάλλον - [zalasio peribalon]
θαλάσσιος πυθμένας - [zalasios pizmenas]
θαλαμηγός - [zalamigos]
θαλασσινά - [zalasina]
θαλασσοκαλλιέργεια - [zalasokaliergia]
θανατική ποινή - [zanatiki pini]
θεία - [zia]
θείο - [zio]
θείος - [zios]
θειική ένωση - [ziiki enosi]
θειικό οξυ - [ziiko oksi]
θειούχοχος ένωση - [ziujojos enosi]
θεληματικότητα - [zelimatikotita]
θεματική ομάδα - [zematiki omada]
θεοκρατία - [zeokratia]
θεολόγος - [zeologos]
θεοποιώ - [zeopio]
θερίζω - [zeriso]
θεραπεία - [zerapia]
θεραπευτικός - [zerapeftikos]
θεραπεύσιμος - [zerapefsimos]
θερισμός - [zerismos]
θερμά ύδατα - [zerma idata]
θερμάστρα - [zermastra]
θερμίδα - [zermida]
θερμικά ύδατα - [zermika idata]
θερμική ρύπανση - [zermiki ripansi]
θερμοδυναμική - [zermodinamiki]
θερμοκήπιο - [zermokipio]
θερμοκρασία - [zermokrasia]
θερμοπίδακας - [zermopidakas]
θερμόαιμο ζώο - [zermoemo soo]
θερμόλουτρό - [zermolutro]
θερμόμετρο - [zermometro]
θερμότητα - [zermotita]
θετή μητέρα - [zeti mitera]
θετική επιστήμη - [zetiki epistimi]
θεωρία - [zeoria]
θεωρία του κράτους πρόνοιας - [zeoria tu kratus pronias]
θεωρία του χάους - [zeoria tu jaus]
θεότητα - [zeotita]
θεώρημα - [zeorima]
θηλαστικά - [zilastika]
θηλαστικό - [zilastiko]
θηλυκός - [zilikos]
θημωνιά - [zimonia]
θησαυρός - [zisafros]
θνησιγένεια - [znisigenia]
θνησιγενής - [znisigenis]
θνησιμότητα - [znisimotita]
θρέψη - [zrepsi]
θρήσκευμα - [zriskefma]
θρήσκος - [zriskos]
θρίαμβος - [zriambos]
θρίπτης - [zriptis]
θρεπτικήαξία τροφίμων - [zreptikiaksia trofimon]
θρεπτικό μέσο - [zreptiko meso]
θρησκεία - [zriskia]
θρησκευτικά - [zriskeftika]
θριαμβεύω - [zriambefo]
θυγατέρα - [zigatera]
θυλάκιο - [zilakio]
θυμάμαι - [zimame]
θυμάρι - [zimari]
θυμωμένος - [zimomenos]
θυρεοειδής αδένας - [zireoidis adenas]
θωρηκτό - [zorikto]
θόλωμα - [zoloma]
θόλωση - [zolosi]
θόριο - [zorio]
θόρυβος - [zoribos]
θόρυβος βάθους - [zoribos bazus]
θόρυβος κυκλοφορίας - [zoribos kikloforias]
θύελλα - [ziela]
θύμα πολέμου - [zima polemu]
θύρα - [zira]
θώρακας - [zorakas]
ιαγουάρος - [iaguaros]
ιαπωνικά - [iaponika]
ιατρική - [iatriki]
ιατρική επίσκεψη - [iatriki episkepsi]
ιατρός - [iatros]
ιγμορίτιδα - [igmoritida]
ιδέα - [idea]
ιδίωμα - [idioma]
ιδεολογία - [ideologia]
ιδιοκτήτης - [idioktitis]
ιδιοκτησία - [idioktisia]
ιδιωτικοποίηση - [idiotikopiisi]
ιδιωτικό δίκαιο - [idiotiko dikeo]
ιδιωτικό διεθνές δίκαιο - [idiotiko dieznes dikeo]
ιδιωτικός τομέας - [idiotikos tomeas]
ιδιόκτητο δάσος - [idioktito dasos]
ιδιόλεκτος - [idiolektos]
ιδιότητα - [idiotita]
ιδρώνω - [idrono]
ιδρώτας - [idrotas]
ιεροσυλία - [ierosilia]
ιζηματαπόθεση - [isimatapozesi]
ιζηματογένεση - [isimatogenesi]
ιζηματογενής λεκάνη - [isimatogenis lekani]
ιζηματολογία - [isimatologia]
ικανοποιημένος - [ikanopiimenos]
ικανοποιητικός - [ikanopiitikos]
ικανότητα τερατογένεσης - [ikanotita teratogenesis]
ιλύς - [ilis]
ιματισμός - [imatismos]
ινδικό - [indiko]
ινδονησιακά - [indonisiaka]
ιξώδες - [iksodes]
ιοί - [ii]
ιολογία - [iologia]
ιοντοανταλλάκτης - [iodoadalaktis]
ιονόσφαιρα - [ionosfera]
ιπποπόταμος - [ipopotamos]
ιππόκαμπος - [ipokabos]
ιπτάμενη τέφρα - [iptameni tefra]
ιρλανδικά - [irlandika]
ισημερινό κλίμα - [isimerino klima]
ισημερινός - [isimerinos]
ισλανδικά - [islandika]
ισοβουτάνιο - [isobutanio]
ισοδύναμη δόση - [isodinami dosi]
ισοζύγιο αποβλήτων - [isosigio apobliton]
ισομερές - [isomeres]
ισοπέδωση - [isopedosi]
ισορροπία - [isoropia]
ισορροπία της ύλης - [isoropia tis ilis]
ισπανικά - [ispanika]
ιστολόγιο - [istologio]
ιστορία - [istoria]
ιστορική έρευνα - [istoriki erefna]
ιστορική τοποθεσία - [istoriki topozesia]
ιστορικό - [istoriko]
ιστορικό κέντρο - [istoriko kedro]
ιστορικός - [istorikos]
ιστόγραμμα - [istograma]
ιστός - [istos]
ισχίο - [isjio]
ισχυρίζομαι - [isjirisome]
ισχυρό αλκαλικό διάλυμα - [isjiro alkaliko dialima]
ισχύς - [isjis]
ισχύς εκπομπής - [isjis ekpobis]
ισότοπο - [isotopo]
ιταλικός - [italikos]
ιτιά - [itia]
ιχθυαπόθεμα - [ijziapozema]
ιχθυολογία - [ijziologia]
ιχνηθέτης - [ijnizetis]
ιχνοστοιχεία - [ijnostijia]
ιόντα - [ioda]
ιόχρουν - [iojrun]
ιώδιο - [iodio]
κάδμιο - [kadmio]
κάδος απορριμμάτων - [kados aporimaton]
κάθαρση - [kazarsi]
κάκωση - [kakosi]
κάλιο - [kalio]
κάλλιο πέντε και στο χέρι παρά δέκα και καρτέρει - [kalio pede ke sto jeri para deka ke karteri]
κάλτσα - [kaltsa]
κάλυμμα - [kalima]
κάλυψη - [kalipsi]
κάλυψη εδαφικών εκτάσεων - [kalipsi edafikon ektaseon]
κάλυψη του εδάφους - [kalipsi tu edafus]
κάλυψη του χώρου ταφής απορριμμάτων - [kalipsi tu joru tafis aporimaton]
κάμινος - [kaminos]
κάμνω - [kamno]
κάμπια - [kabia]
κάνναβη - [kanabi]
κάνω ηλιοθεραπεία - [kano iliozerapia]
κάνω μπάνιο - [kano banio]
κάνω ντους - [kano dus]
κάπνισμα - [kapnisma]
κάπρος - [kapros]
κάρβουνο - [karbuno]
κάρδαμο - [kardamo]
κάστανο - [kastano]
κάστορας - [kastoras]
κάστρο - [kastro]
κάταγμα - [katagma]
κάτοικος - [katikos]
κάτοπτρο - [katoptro]
κάτω γνάθος - [kato gnazos]
κάτωχρος - [katojros]
κάψουλα - [kapsula]
κέικ - [kik]
κέντρο ανταλλαγής πληροφοριών - [kedro adalagis pliroforion]
κέντρο δεδομένων - [kedro dedomenon]
κέντρο περίθαλψης - [kedro perizalpsis]
κέντρο πληροφοριών - [kedro pliroforion]
κέντρο πυρηνικών ερευνών - [kedro pirinikon erefnon]
κέντρο τεκμηρίωσης - [kedro tekmiriosis]
κέντρο τηλεανίχνευσης - [kedro tileanijnefsis]
κέντρο της πόλης - [kedro tis polis]
κέντρο χειμερινού αθλητισμού - [kedro jimerinu azlitismu]
κέρατο - [kerato]
κέρδος - [kerdos]
κέρμα - [kerma]
κέτσαπ - [ketsap]
κήπος - [kipos]
κήπος αγγλικού τύπου - [kipos agliku tipu]
κήπος κατοικίας - [kipos katikias]
κίνδυνοι - [kindini]
κίνδυνος από τα πυρηνικά - [kindinos apo ta pirinika]
κίνδυνος εμφάνισης καρκίνου - [kindinos emfanisis karkinu]
κίνδυνος καρκινογένεσης - [kindinos karkinogenesis]
κίνηση αερίων μαζών - [kinisi aerion mason]
κίρρωσις - [kirosis]
κίσσα - [kisa]
κίτρινο - [kitrino]
κίτρινος - [kitrinos]
κα - [ka]
καίσιο - [kesio]
καβάλα - [kabala]
καβατίνα - [kabatina]
καβουρντίζω - [kaburdiso]
καβούρι - [kaburi]
καγκουρό - [kagkuro]
καζαχστανικά - [kasajstanika]
καθίζηση - [kazisisi]
καθίζηση του εδάφους - [kazisisi tu edafus]
καθαρή εξάντληση πόρων - [kazari eksadlisi poron]
καθαρή τεχνολογία - [kazari tejnologia]
καθαρισμός - [kazarismos]
καθαρισμός αερίων - [kazarismos aerion]
καθαρισμός του ύδατος - [kazarismos tu idatos]
καθαριότητα - [kazariotita]
καθαρτικό - [kazartiko]
καθαρό αυτοκίνητο - [kazaro aftokinito]
καθαρός - [kazaros]
καθεστώς που διέπει τις απολύσεις - [kazestos pu diepi tis apolisis]
καθολική αποξήρανση - [kazoliki apoksiransi]
καθολικισμός - [kazolikismos]
καθολικός - [kazolikos]
καθρέφτης - [kazreftis]
και - [ke]
και λοιπά - [ke lipa]
και τα λοιπά - [ke ta lipa]
καινοτομία - [kenotomia]
καιρικές συνθήκες - [kerikes sinzikes]
καιρική μεταβολή - [keriki metaboli]
καιρός - [keros]
κακάο - [kakao]
κακοπιστία - [kakopistia]
κακοφωνία - [kakofonia]
κακόβουλος - [kakobulos]
καλά - [kala]
καλάθι - [kalazi]
καλή όρεξη - [kali oreksi]
καλαθοσφαίριση - [kalazosferisi]
καλαμποκάλευρο - [kalabokalefro]
καλημέρα - [kalimera]
καληνύχτα - [kalinijta]
καλησπέρα - [kalispera]
καλιούχο λίπασμα - [kaliujo lipasma]
καλιφόρνιο - [kalifornio]
καλλίπυγος - [kalipigos]
καλλιέργεια - [kaliergia]
καλλιέργεια αποψιλωμένου και καμένου εδάφους - [kaliergia apopsilomenu ke kamenu edafus]
καλλιέργεια βολβών - [kaliergia bolbon]
καλλιέργεια θερμοκηπίου - [kaliergia zermokipiu]
καλλιέργεια κατά τις ισοϋψείς καμπύλες - [kaliergia kata tis isupsis kabiles]
καλλιέργεια λαχανικών - [kaliergia lajanikon]
καλλιγραφία - [kaligrafia]
καλλιεργημένο φυτό - [kaliergimeno fito]
καλλιτέχνης - [kalitejnis]
καλλιτεχνικά - [kalitejnika]
καλλωπιστικά φυτά - [kalopistika fita]
καλοκαίρι - [kalokeri]
καλοκαιρινό σχολείο - [kalokerino sjolio]
καλό - [kalo]
καλόγερος - [kalogeros]
καλύψο - [kalipso]
καλώ - [kalo]
καλώδιο - [kalodio]
καλώς όρισες - [kalos orises]
καμάκι - [kamaki]
καμάρα ποδιού - [kamara podiu]
καμήλα - [kamila]
καμηλοπάρδαλη - [kamilopardali]
καμουφλάζ - [kamuflas]
καμπαναριό - [kabanario]
καμπανολογία - [kabanologia]
καμπυλότητα - [kabilotita]
καμφορά - [kamfora]
κανάλι - [kanali]
κανάτα - [kanata]
καναπές - [kanapes]
καναρίνι - [kanarini]
κανιβαλισμός - [kanibalismos]
κανονικοποίηση - [kanonikopiisi]
κανονισμός - [kanonismos]
κανονισμός εξόρυξης - [kanonismos eksoriksis]
κανω εμετό - [kano emeto]
κανόνας - [kanonas]
κανόνας ασφαλείας - [kanonas asfalias]
κανόνι - [kanoni]
καουτσούκ - [kautsuk]
καπέλο - [kapelo]
καπνίζω - [kapniso]
καπνισμός - [kapnismos]
καπνοδόχος - [kapnodojos]
καπνός - [kapnos]
καπνός τσιγάρου - [kapnos tsigaru]
καράτε - [karate]
καράτι - [karati]
καρέκλα - [karekla]
καρακάξα - [karakaksa]
καρδιά - [kardia]
καρδινάλιος - [kardinalios]
καρδιολογία - [kardiologia]
καρκίνοι - [karkini]
καρκίνος - [karkinos]
καρκινική επιγραφ - [karkiniki epigraf]
καρκινογένεση - [karkinogenesi]
καρκινοειδή - [karkinoidi]
καρπουζιά - [karpusia]
καρπούζι - [karpusi]
καρπός - [karpos]
καρχαρίας - [karjarias]
καρότο - [karoto]
καρύκευμα - [karikefma]
κασκόλ - [kaskol]
κασσίτερος - [kasiteros]
καστανέα - [kastanea]
καστανιά - [kastania]
καστανιέτα - [kastanieta]
καστανό - [kastano]
καστανός - [kastanos]
κατ' έφεση δίκη - [kat efesi diki]
κατ' αντιδιαστολή προς - [kat adidiastoli pros]
κατάθλιψη - [katazlipsi]
κατάληψη - [katalipsi]
κατάλογος - [katalogos]
κατάλοιπα φυτοφαρμάκου - [katalipa fitofarmaku]
κατάλυμα - [katalima]
κατάλυση - [katalisi]
κατάσταση καιρού - [katastasi keru]
κατάσταση της ανάπτυξης - [katastasi tis anaptiksis]
κατάσταση της ύλης - [katastasi tis ilis]
κατάσταση όσον αφορά τις εκπομπές - [katastasi oson afora tis ekpobes]
κατάστημα - [katastima]
κατάσχεση - [katasjesi]
κατάσχω - [katasjo]
κατάχρηση - [katajrisi]
καταβοθρα - [katabozra]
καταγραφή - [katagrafi]
καταδίκη - [katadiki]
καταδικάζω - [katadikaso]
καταδικαστική απόφαση - [katadikastiki apofasi]
καταθέτω - [katazeto]
καταιγίδα - [kategida]
καταιονητήρας - [kateonitiras]
κατακλυσμός - [kataklismos]
καταλανικά - [katalanika]
καταληκτική κατάσταση - [kataliktiki katastasi]
καταλογισμός - [katalogismos]
καταλυτικός μετατροπέας - [katalitikos metatropeas]
καταλύτης - [katalitis]
καταμαράν - [katamaran]
κατανάλωση ενέργειας - [katanalosi energias]
κατανάλωση ηλεκτρικής ενέργειας - [katanalosi ilektrikis energias]
κατανάλωση καυσίμου - [katanalosi kafsimu]
κατανάλωση πετρελαίου - [katanalosi petreleu]
κατανάλωση πρωτογενούς ενέργειας - [katanalosi protogenus energias]
κατανάλωση ύδατος - [katanalosi idatos]
καταναλωτικό προϊόν - [katanalotiko prion]
κατανομή - [katanomi]
κατανομή πληθυσμού - [katanomi plizismu]
καταπέλτης - [katapeltis]
καταπλήσσω - [katapliso]
καταπληκτικός - [katapliktikos]
καταπόνηση - [kataponisi]
καταρράκτης - [kataraktis]
κατασκήνωση - [kataskinosi]
κατασκευή ηλεκτρολογικών και ηλεκτρονικών ειδών - [kataskefi ilektrologikon ke ilektronikon idon]
κατασκευή μηχανών - [kataskefi mijanon]
καταστατικό κείμενο - [katastatiko kimeno]
καταστροφές - [katastrofes]
καταστροφή - [katastrofi]
καταστροφή από πετρέλαιο - [katastrofi apo petreleo]
καταυλισμός - [kataflismos]
καταφύγιο - [katafigio]
καταφύγιο έκτακτης ανάγκης - [katafigio ektaktis anagkis]
καταφύγιο ζώων - [katafigio soon]
καταφύγιο πτηνών - [katafigio ptinon]
καταχρώμαι - [katajrome]
καταχώρηση - [katajorisi]
κατεργασία ελαστικού - [katergasia elastiku]
κατεργασμένο τρόφιμο - [katergasmeno trofimo]
κατηγορία - [katigoria]
κατιόν - [kation]
κατοικία - [katikia]
κατοικία μονογονεϊκής οικογένειας - [katikia monogonikis ikogenias]
κατοικίδιο ζώο - [katikidio soo]
κατολίσθηση - [katoliszisi]
κατολίσθηση χιόνων - [katoliszisi jionon]
κατορθώνω - [katorzono]
κατοχή - [katoji]
κατσαβίδι - [katsabidi]
κατσαρίδες - [katsarides]
κατσαρόλα - [katsarola]
κατσικάκι - [katsikaki]
κατόπιν - [katopin]
καυγάς - [kafgas]
καυσαέρια - [kafsaeria]
καυσαέριο - [kafsaerio]
καυσόξυλο - [kafsoksilo]
καυτερή πιπεριά - [kafteri piperia]
καφές - [kafes]
καφενείο - [kafenio]
καφεόδεντρο - [kafeodedro]
καύση ελέγχου σε πυρσό - [kafsi elegju se pirso]
καύση σε πυρσό - [kafsi se pirso]
καύσιμα ντίζελ - [kafsima disel]
καύσιμη αλκοόλη - [kafsimi alkooli]
καύσιμο - [kafsimo]
καύσιμο κινητήρα - [kafsimo kinitira]
κβας - [kbas]
κείμενα - [kimena]
κεκλεισμένων των θυρών - [keklismenon ton ziron]
κεντροευρωπαϊκός - [kedroefropekos]
κεράσι - [kerasi]
κερί - [keri]
κεραμική - [keramiki]
κεραμική βιομηχανία - [keramiki biomijania]
κερατώνω - [keratono]
κερδοσκοπική δραστηριότητα - [kerdoskopiki drastiriotita]
κεφάλι - [kefali]
κεφαλοθώρακας - [kefalozorakas]
κεφαλόποδα - [kefalopoda]
κεχαριτωμένη - [kejaritomeni]
κεχρί - [kejri]
κεχριμπάρι - [kejribari]
κηδεία - [kidia]
κηδεμόνας - [kidemonas]
κηπευτική - [kipeftiki]
κηπουρική - [kipuriki]
κηπουρός - [kipuros]
κηροζίνη - [kirosini]
κηρύθρα - [kirizra]
κητοειδή - [kitoidi]
κηφήνας - [kifinas]
κιάλια - [kialia]
κιβώτιο μελάνης - [kibotio melanis]
κιβώτιο ταχυτήτων - [kibotio tajititon]
κιθάρα - [kizara]
κιλό - [kilo]
κιμωλία - [kimolia]
κινέζικα - [kinesika]
κινεζικά - [kinesika]
κινεζικό γουάν - [kinesiko guan]
κινηματογράφος - [kinimatografos]
κινηματογραφική ταινία - [kinimatografiki tenia]
κινηματογραφώ - [kinimatografo]
κινητήρας - [kinitiras]
κινητήρας αερίου - [kinitiras aeriu]
κινητήρας καύσης - [kinitiras kafsis]
κινητήρας ντίζελ - [kinitiras disel]
κινητική της αντίδρασης - [kinitiki tis adidrasis]
κινητό - [kinito]
κινόα - [kinoa]
κινώ - [kino]
κιούριο - [kiurio]
κιτρικό οξύ - [kitriko oksi]
κιόσκι - [kioski]
κλάδευση - [kladefsi]
κλάδος - [klados]
κλάδος ασφαλίσεων - [klados asfaliseon]
κλάδος δικαίου - [klados dikeu]
κλάδος της τυπογραφίας - [klados tis tipografias]
κλάδος υγειονομικής περίθαλψης - [klados igionomikis perizalpsis]
κλάνω - [klano]
κλέφτης - [kleftis]
κλήρος - [kliros]
κλίβανος - [klibanos]
κλίμα - [klima]
κλίμακα - [klimaka]
κλίση - [klisi]
κλαίω - [kleo]
κλαδί - [kladi]
κλαρινέτο - [klarineto]
κλείδωση - [klidosi]
κλείνω - [klino]
κλειδί - [klidi]
κλειδοκύμβαλο - [klidokimbalo]
κλειστοφοβία - [klistofobia]
κλειτορίδα - [klitorida]
κληρονομικός - [klironomikos]
κλητήρας - [klitiras]
κλιματική διαταραχή - [klimatiki diataraji]
κλιματική ζώνη - [klimatiki soni]
κλιματική μεταβολή - [klimatiki metaboli]
κλιματισμός - [klimatismos]
κλιματιστικό - [klimatistiko]
κλιματολογία - [klimatologia]
κλινικό σύμπτωμα - [kliniko sibtoma]
κλιτύς - [klitis]
κλπ - [klp]
κλωβός - [klobos]
κλωνοποίηση - [klonopiisi]
κλωστικό φυτό - [klostiko fito]
κλωστοϋφαντουργία - [klostufadurgia]
κνίδωση - [knidosi]
κνησμός - [knismos]
κοάλα - [koala]
κοίτασμα ορυκτού - [kitasma oriktu]
κοίτη ποταμού - [kiti potamu]
κοβάλτιο - [kobaltio]
κοιλάδα - [kilada]
κοιλαδογέφυρα - [kiladogefira]
κοιλεντερωτά - [kilederota]
κοιλιά - [kilia]
κοιμάμαι - [kimame]
κοιμητήριο - [kimitirio]
κοινή γνώμη - [kini gnomi]
κοινοβουλευτική έκθεση - [kinobuleftiki ekzesi]
κοινοβουλευτική συζήτηση - [kinobuleftiki sisitisi]
κοινοπολιτεία - [kinopolitia]
κοινοπραξία - [kinopraksia]
κοινωνία - [kinonia]
κοινωνικές επιστήμες - [kinonikes epistimes]
κοινωνική ανάπτυξη - [kinoniki anaptiksi]
κοινωνική ανισότητα - [kinoniki anisotita]
κοινωνική ασφάλεια - [kinoniki asfalia]
κοινωνική ασφάλιση - [kinoniki asfalisi]
κοινωνική διαφοροποίηση - [kinoniki diaforopiisi]
κοινωνική δομή - [kinoniki domi]
κοινωνική δυναμική - [kinoniki dinamiki]
κοινωνική ιατρική - [kinoniki iatriki]
κοινωνική κατάσταση - [kinoniki katastasi]
κοινωνική ομάδα - [kinoniki omada]
κοινωνική πολιτική - [kinoniki politiki]
κοινωνική συμμετοχή - [kinoniki simetoji]
κοινωνική ψυχολογία - [kinoniki psijologia]
κοινωνικοπολιτιστική ομάδα - [kinonikopolitistiki omada]
κοινωνικό κίνημα - [kinoniko kinima]
κοινωνικό πρόβλημα - [kinoniko problima]
κοινωνικό σύστημα - [kinoniko sistima]
κοινωνιολογία - [kinoniologia]
κοινωνιολογική οικονομία - [kinoniologiki ikonomia]
κοινωνιόλεκτος - [kinoniolektos]
κοινό - [kino]
κοινό κρυολόγημα - [kino kriologima]
κοκαΐνη - [kokaΐni]
κοκαλιάρης - [kokaliaris]
κοκοφοίνικας - [kokofinikas]
κολαστήριο - [kolastirio]
κολεόπτερα - [koleoptera]
κολιέ - [kolie]
κολλάρισμα - [kolarisma]
κολλητική ταινία - [kolitiki tenia]
κολλοειδές - [koloides]
κολλοειδής κατάσταση - [koloidis katastasi]
κολοβακτηρίδια - [kolobaktiridia]
κολοκυθάκι - [kolokizaki]
κολουβρίδες - [kolubrides]
κολπίσκος - [kolpiskos]
κολυμπάω - [kolibao]
κολώνα - [kolona]
κομήτης - [komitis]
κομητεία - [komitia]
κομμουνισμός - [komunismos]
κομμό - [komo]
κομπογιαννίτης - [kobogianitis]
κονιορτός - [koniortos]
κοντός - [kodos]
κοπή - [kopi]
κοπριά - [kopria]
κοπρόχωμα από απόβλητη λάσπη - [koprojoma apo apobliti laspi]
κοράλλια - [koralia]
κορέοι - [korei]
κορίτσι - [koritsi]
κοραλλιογενής λιμνοθάλασσα - [koraliogenis limnozalasa]
κοραλλιογενής ύφαλος - [koraliogenis ifalos]
κορεατικά - [koreatika]
κοριός - [korios]
κορμός - [kormos]
κορυφή - [korifi]
κορόνα - [korona]
κορύφωση - [korifosi]
κος - [kos]
κοσκίνιση - [koskinisi]
κοσκίνισμα - [koskinisma]
κοσμηματοπωλείο - [kosmimatopolio]
κοσμική ακτινοβολία - [kosmiki aktinobolia]
κοσμοδρόμιο - [kosmodromio]
κοστούμι - [kostumi]
κοτόπουλο - [kotopulo]
κουάρκ - [kuark]
κουβέντα - [kubeda]
κουβέρτα - [kuberta]
κουζίνα - [kusina]
κουκουβάγια - [kukubagia]
κουνέλι - [kuneli]
κουνιστή καρέκλα - [kunisti karekla]
κουνουπίδι - [kunupidi]
κουνούπι - [kunupi]
κουρασμένος - [kurasmenos]
κουρκούμη - [kurkumi]
κουρούνα - [kuruna]
κουρτίνα - [kurtina]
κουτάλα - [kutala]
κουτάλι - [kutali]
κοχλίας - [kojlias]
κοόρτις - [koortis]
κούκλα - [kukla]
κούκος - [kukos]
κούπα - [kupa]
κούραση - [kurasi]
κράμβη - [krambi]
κράτηση - [kratisi]
κρέας - [kreas]
κρήνη - [krini]
κρίκετ - [kriket]
κρίνο - [krino]
κρίσιμο επίπεδο - [krisimo epipedo]
κρίσιμο φορτίο - [krisimo fortio]
κραγιόν - [kragion]
κρανίο - [kranio]
κρασί - [krasi]
κρασοπότηρο - [krasopotiro]
κρατάω - [kratao]
κρατικό δάσος - [kratiko dasos]
κρατώ - [krato]
κρεατομάχαιρο - [kreatomajero]
κρεατοπαραγωγό βοοειδές - [kreatoparagogo booides]
κρεβάτι - [krebati]
κρεβατοκάμαρα - [krebatokamara]
κρεμάστρα - [kremastra]
κρεμμύδι - [kremidi]
κρεμυδι - [kremidi]
κρημνός - [krimnos]
κρητίδα - [kritida]
κριθάρι - [krizari]
κριτική - [kritiki]
κροατικά - [kroatika]
κροκοδειλίδες - [krokodilides]
κρουαζιερόπλοιο - [kruasieroplio]
κρυολόγημα - [kriologima]
κρυπτονόμισμα - [kriptonomisma]
κρυπτό - [kripto]
κρυπτόγαμα - [kriptogama]
κρυστάλλωση - [kristalosi]
κρυσταλλογραφία - [kristalografia]
κρυσταλλοποίηση - [kristalopiisi]
κρυσταλλώνω - [kristalono]
κρυφτό - [krifto]
κρυφός - [krifos]
κρόκος - [krokos]
κρόταφος - [krotafos]
κρότος - [krotos]
κρύο - [krio]
κρύσταλλο - [kristalo]
κρύσταλλος - [kristalos]
κτήμα - [ktima]
κτήριο - [ktirio]
κτίριο - [ktirio]
κτηματολόγιο - [ktimatologio]
κτηνίατρος - [ktiniatros]
κτηνιατρική - [ktiniatriki]
κτηνοτροφία - [ktinotrofia]
κτλ - [ktl]
κυανίδιο - [kianidio]
κυανικό άλας - [kianiko alas]
κυανοφύκη - [kianofiki]
κυανό - [kiano]
κυβερνήτης - [kibernitis]
κυδώνι - [kidoni]
κυκλοπροπάνιο - [kiklopropanio]
κυκλοφορία στους ωκεανούς - [kikloforia stus okeanus]
κυκλοφοριακή ρύθμιση - [kikloforiaki rizmisi]
κυκλοφοριακή συμφόρηση - [kikloforiaki simforisi]
κυκλοφοριακή υποδομή - [kikloforiaki ipodomi]
κυκλώνας - [kiklonas]
κυλίνδρωση - [kilindrosi]
κυματική ενέργεια - [kimatiki energia]
κυματισμός - [kimatismos]
κυνίδες - [kinides]
κυνηγετική άδεια - [kinigetiki adia]
κυνηγώ - [kinigo]
κυνικός - [kinikos]
κυνόδοντας - [kinododas]
κυπρίνος - [kiprinos]
κυπριακός - [kipriakos]
κυρία - [kiria]
κυριλλικό αλφάβητο - [kiriliko alfabito]
κυστική ίνωση - [kistiki inosi]
κυτταρίνη - [kitarini]
κυτταρολογία - [kitarologia]
κυτταροτοξικότητα - [kitarotoksikotita]
κυψέλη - [kipseli]
κυψελίδα - [kipselida]
κωδικοποίηση - [kodikopiisi]
κωδωνοκρούστης - [kodonokrustis]
κωκ - [kok]
κωλοφωτιά - [kolofotia]
κωλόχαρτο - [kolojarto]
κωμωδία - [komodia]
κωμωδία κατάστασης - [komodia katastasis]
κωμόπολη - [komopoli]
κωνοφόρα - [konofora]
κωνοφόρο δένδρο - [konoforo dendro]
κόβω - [kobo]
κόκαλο - [kokalo]
κόκκαλο - [kokkalo]
κόκκινο - [kokkino]
κόκκινος - [kokkinos]
κόκκινος κατάλογος - [kokkinos katalogos]
κόκκος - [kokkos]
κόκορας - [kokoras]
κόλαση - [kolasi]
κόλλα - [kola]
κόλπος - [kolpos]
κόμης - [komis]
κόμισσα - [komisa]
κόμμωση - [komosi]
κόπος - [kopos]
κόρη - [kori]
κόσκινο - [koskino]
κόσμος - [kosmos]
κόστος - [kostos]
κόστος μεταφοράς - [kostos metaforas]
κόστος ταξιδίου - [kostos taksidiu]
κόστος της προστασίας του περιβάλλοντος - [kostos tis prostasias tu peribalodos]
κόστος του νερού - [kostos tu neru]
κότα - [kota]
κότσυφας - [kotsifas]
κύβος - [kibos]
κύκλος αζώτου - [kiklos asotu]
κύκλος ζωής προϊόντος - [kiklos sois priodos]
κύκλος του άνθρακα - [kiklos tu anzraka]
κύκνος - [kiknos]
κύμα - [kima]
κύμβαλο - [kimbalo]
κύριο πιάτο - [kirio piato]
κύρωση - [kirosi]
κύστη - [kisti]
κύτταρο - [kitaro]
κώμα - [koma]
κώνος - [konos]
λάιβ - [leb]
λάκα - [laka]
λάμα - [lama]
λάμπα - [laba]
λάρικας - [larikas]
λάσπη - [laspi]
λάστιχο - [lastijo]
λάχανο - [lajano]
λέαινα - [leena]
λέγω - [lego]
λέιζερ - [liser]
λέμβος - [lembos]
λέξη - [leksi]
λέω - [leo]
λήψη νερού - [lipsi neru]
λίθιο - [lizio]
λίθος - [lizos]
λίθος κυλινδόμενος το φυκος ου ποιεί - [lizos kilindomenos to fikos u pii]
λίμα - [lima]
λίμνη - [limni]
λίπανση του εδάφους - [lipansi tu edafus]
λίπασμα - [lipasma]
λίπασμα ζωικής προέλευσης - [lipasma soikis proelefsis]
λίπος - [lipos]
λίρα - [lira]
λίρα αγγλίας - [lira aglias]
λίτρο - [litro]
λαβύρινθος - [labirinzos]
λαγήνι - [lagini]
λαζαρέτο - [lasareto]
λαθροθηρία - [lazroziria]
λαιμαργία - [lemargia]
λαιμοδέτης - [lemodetis]
λαιμός - [lemos]
λαμπτήρας - [labtiras]
λαμπτήρες φθορισμού - [labtires fzorismu]
λανθάνιο - [lanzanio]
λαογραφία - [laografia]
λαογραφική παράδοση - [laografiki paradosi]
λαούτο - [lauto]
λαρυγγίτιδα - [larigitida]
λατινικά - [latinika]
λατομείο - [latomio]
λατρεία - [latria]
λατόμευση - [latomefsi]
λατύπη - [latipi]
λαχανικό - [lajaniko]
λαχείο - [lajio]
λαχτάρα - [lajtara]
λαϊκή παράδοση - [leki paradosi]
λαϊκός πολιτισμός - [lekos politismos]
λείανση - [liansi]
λειβαδικό οικοσύστημα - [libadiko ikosistima]
λειμώνας - [limonas]
λειτουργική ουσία - [liturgiki usia]
λειχήνες - [lijines]
λεκάνη - [lekani]
λεκάνη απορροής - [lekani aporois]
λεμβοδρομία - [lembodromia]
λεμονάδα - [lemonada]
λεμφικό σύστημα - [lemfiko sistima]
λεμόνι - [lemoni]
λεξικό - [leksiko]
λεξιλόγιο - [leksilogio]
λεπίδα - [lepida]
λεπιδόπτερα - [lepidoptera]
λεπτό - [lepto]
λεπτόνιο - [leptonio]
λεπτός - [leptos]
λεσβία - [lesbia]
λεττονικά - [letonika]
λευκίσκος ο αλβούρνος - [lefkiskos o alburnos]
λευκαντική άργιλος - [lefkadiki argilos]
λευκαντική ουσία - [lefkadiki usia]
λευκό - [lefko]
λευκός - [lefkos]
λευκόχρυσος - [lefkojrisos]
λευχαιμία - [lefjemia]
λεωφορείο - [leoforio]
λεωφόρος - [leoforos]
λεύκα - [lefka]
λεύκανση - [lefkansi]
λιανικός - [lianikos]
λιβάδι - [libadi]
λιβαδική έκταση με διάσπαρτα αλσύλλια - [libadiki ektasi me diasparta alsilia]
λιγνίτης - [lignitis]
λιγοστεύω - [ligostefo]
λιθουανικά - [lizuanika]
λιθόσφαιρα - [lizosfera]
λιμάρω - [limaro]
λιμένας - [limenas]
λιμβουργιανά - [limburgiana]
λιμναία ρύπανση - [limnea ripansi]
λιμνολεκάνη - [limnolekani]
λιμνολογία - [limnologia]
λιμός - [limos]
λινάρι - [linari]
λινό - [lino]
λιοντάρι - [liodari]
λιονταρίνα - [liodarina]
λιπίδιο - [lipidio]
λιπαίνω - [lipeno]
λιπαντικό - [lipadiko]
λιπασματοποίηση - [lipasmatopiisi]
λιτός - [litos]
λιτότητα - [litotita]
λοίμωξη - [limoksi]
λογάριθμος - [logarizmos]
λογικά - [logika]
λογισμικό - [logismiko]
λογιστής - [logistis]
λογιστική - [logistiki]
λογιστική του δημοσίου - [logistiki tu dimosiu]
λογιστικό σύστημα - [logistiko sistima]
λογοκλοπή - [logoklopi]
λογοπαίγνιο - [logopegnio]
λογοτεχνία - [logotejnia]
λοιμός - [limos]
λουκάνικο - [lukaniko]
λουλουδίζω - [luludiso]
λουλούδι - [luludi]
λουξεμβουργιανά - [luksemburgiana]
λουτέτιο - [lutetio]
λουτέτσιο - [lutetsio]
λουτήτιο - [lutitio]
λουτρό - [lutro]
λυκόφως - [likofos]
λυπημένος - [lipimenos]
λυσιμετρία - [lisimetria]
λυχνία - [lijnia]
λωρένσιο - [lorensio]
λόγος - [logos]
λόξιγκας - [loksigkas]
λόφος - [lofos]
λύγκας - [ligkas]
λύκαινα - [likena]
λύκος - [likos]
λύματα - [limata]
λύπη - [lipi]
λύτρα - [litra]
λύτρωση - [litrosi]
μάγειρος - [magiros]
μάγος - [magos]
μάγουλο - [magulo]
μάζα - [masa]
μάθημα - [mazima]
μάλιστα - [malista]
μάμμη - [mami]
μάνγκο - [mangko]
μάντις - [madis]
μάραθο - [marazo]
μάρκετινγκ - [marketingk]
μάρμαρο - [marmaro]
μάσηση - [masisi]
μάσκαρα - [maskara]
μάτι - [mati]
μάχη - [maji]
μέγεθος - [megezos]
μέγιστη επιτρεπόμενη συγκέντρωση - [megisti epitrepomeni sigkedrosi]
μέγιστη συγκέντρωση όχλησης - [megisti sigkedrosi ojlisis]
μέδουσα - [medusa]
μέθοδος - [mezodos]
μέθοδος ερμηνείας - [mezodos erminias]
μέθοδος καλλιέργειας - [mezodos kaliergias]
μέθοδος προσδιορισμού - [mezodos prosdiorismu]
μέικαπ - [mikap]
μέλι - [meli]
μέλισσες - [melises]
μέρισμα - [merisma]
μέρος - [meros]
μέρος του λόγου - [meros tu logu]
μέσα - [mesa]
μέση - [mesi]
μέση τιμή - [mesi timi]
μέσο ους - [meso us]
μέσο συμπλοκοποίησης - [meso siblokopiisis]
μέσος - [mesos]
μέταλλα - [metala]
μέτρηση - [metrisi]
μέτρηση της ρύπανσης - [metrisi tis ripansis]
μέτρηση του θορύβου - [metrisi tu zoribu]
μέτρηση υδατοπαροχής - [metrisi idatoparojis]
μέτρο - [metro]
μέτρο ασφαλείας - [metro asfalias]
μέτρο για τον μετριασμό - [metro gia ton metriasmo]
μέτωπο - [metopo]
μήλο - [milo]
μήνας - [minas]
μήνας του μέλιτος - [minas tu melitos]
μήνυμα - [minima]
μίανση - [miansi]
μίλι - [mili]
μίσθωμα - [miszoma]
μίσος - [misos]
μαία - [mea]
μαγαζί - [magasi]
μαγγάνιο - [maganio]
μαγειρεύω - [magirefo]
μαγειρικό λάδι - [magiriko ladi]
μαγιά - [magia]
μαγιό - [magio]
μαγνήσιο - [magnisio]
μαγνήτης - [magnitis]
μαγνητίτης - [magnititis]
μαγνητική ταινία - [magnitiki tenia]
μαγνητισμός - [magnitismos]
μαγνητόμετρο - [magnitometro]
μαζούτ - [masut]
μαθαίνω - [mazeno]
μαθηματικά - [mazimatika]
μαθηματική ανάλυση - [mazimatiki analisi]
μαθηματική λογική - [mazimatiki logiki]
μαθητής - [mazitis]
μακέτα - [maketa]
μακί - [maki]
μακεδονικά - [makedonika]
μακριά - [makria]
μακροοικονομία - [makroikonomia]
μακροοικονομικός στόχος - [makroikonomikos stojos]
μακροπρόθεσμη τάσξ - [makroprozesmi tasks]
μακροχρόνια επίπτωση - [makrojronia epiptosi]
μακρόφυτο - [makrofito]
μακρύς - [makris]
μαλάκια - [malakia]
μαλαγιαλαμικά - [malagialamika]
μαλακτικό - [malaktiko]
μαλακός - [malakos]
μαλλί - [mali]
μαλλιά - [malia]
μαμμή - [mami]
μανίκι - [maniki]
μανδραγόρας - [mandragoras]
μανιτάρι - [manitari]
μανιώδης - [maniodis]
μανταλάκι - [madalaki]
μανταρίνι - [madarini]
μαντολάτο - [madolato]
μανόμετρο - [manometro]
μαξιλάρι - [maksilari]
μαρίνα - [marina]
μαραγκός - [maragkos]
μαραθικά - [marazika]
μαραθώνιος - [marazonios]
μαργαρίνη - [margarini]
μαριχουάνα - [marijuana]
μαρκαδόρος - [markadoros]
μαρούλι - [maruli]
μαρσιποφόρα - [marsipofora]
μαστίχα - [mastija]
μαστεκτομή - [mastektomi]
μαστοφόρο - [mastoforo]
μασχάλη - [masjali]
ματαιώνω - [mateono]
ματζουράνα - [matsurana]
ματογυάλια - [matogialia]
ματωμένος - [matomenos]
ματόκλαδο - [matoklado]
μαυρίζω - [mafriso]
μαυροδέλφινο - [mafrodelfino]
μαχαίρι - [majeri]
μαχαίρι μπριζόλας - [majeri brisolas]
μαχαιροπήρουνα - [majeropiruna]
μαϊστράλι - [mestrali]
μαϊτνέριο - [metnerio]
μαύρος - [mafros]
μείζων κίνδυνος - [mison kindinos]
μεγάλα θηράματα - [megala ziramata]
μεγάλος - [megalos]
μεγαχέρτζ - [megajerts]
μεγιστάνας - [megistanas]
μεζούρα - [mesura]
μεθάνιο - [mezanio]
μεθανιοποίηση - [mezaniopiisi]
μεθανόλη - [mezanoli]
μεθοδικός - [mezodikos]
μεθοδολογίες - [mezodologies]
μεθόριος - [mezorios]
μεικτό δάσος - [mikto dasos]
μειονότητα - [mionotita]
μειοψηφία - [miopsifia]
μειώνομαι - [mionome]
μελάνη - [melani]
μελάσσα - [melasa]
μελάτος - [melatos]
μελέτη - [meleti]
μελέτη έντυπου υλικού - [meleti edipu iliku]
μελέτη ασφαλείας - [meleti asfalias]
μελίσσι - [melisi]
μελαγχολικός - [melagjolikos]
μελανοδοχείο - [melanodojio]
μελανοκύτταρο - [melanokitaro]
μελετάω - [meletao]
μελισσοκομία - [melisokomia]
μελιτζάνα - [melitsana]
μελωδία - [melodia]
μεμβράνη - [membrani]
μενού - [menu]
μεντελέβιο - [medelebio]
μερικώς αλογονωμένος χλωροφθοράνθρακας - [merikos alogonomenos jlorofzoranzrakas]
μεσάζων - [mesason]
μεσάνυχτα - [mesanijta]
μεσεγγύηση - [mesegiisi]
μεσημέρι - [mesimeri]
μεσημεριανό - [mesimeriano]
μεσογειακός - [mesogiakos]
μετάδοση - [metadosi]
μετάκαυση - [metakafsi]
μετάλλευμα - [metalefma]
μετάξι - [metaksi]
μετάφραση - [metafrasi]
μεταίσθημα - [meteszima]
μεταβλητότητα - [metablitotita]
μεταβολίτης - [metabolitis]
μεταβολισμός - [metabolismos]
μεταγλώσσα - [metaglosa]
μεταγλώττιση - [metaglotisi]
μετακινούμενη εργασία - [metakinumeni ergasia]
μετακομίζω - [metakomiso]
μεταλλακτός - [metalaktos]
μεταλλαξιογόνο - [metalaksiogono]
μεταλλαξιογόνος ουσία - [metalaksiogonos usia]
μεταλλείο - [metalio]
μεταλλικά απόβλητα - [metalika apoblita]
μεταλλική επικάλυψη - [metaliki epikalipsi]
μεταλλικό νερό - [metaliko nero]
μεταλλικό ορυκτό - [metaliko orikto]
μετανάστευση ζώων - [metanastefsi soon]
μεταναστευτικοί ιχθύες - [metanasteftiki ijzies]
μεταποίηση - [metapiisi]
μεταποιητικό εμπόριο - [metapiitiko eborio]
μεταπτωτικά στοιχεία - [metaptotika stijia]
μεταστοιχείωση - [metastijiosi]
μεταφορά - [metafora]
μεταφορά νερού - [metafora neru]
μεταφορά τεχνολογίας - [metafora tejnologias]
μεταφορές - [metafores]
μεταφράζω - [metafraso]
μεταφραστής - [metafrastis]
μετεωρολογία - [meteorologia]
μετεωρολογική πρόβλεψη - [meteorologiki problepsi]
μετρητά - [metrita]
μετρική - [metriki]
μετρολογία - [metrologia]
μετρό - [metro]
μετρώ - [metro]
μεφίτιδα - [mefitida]
μη ανανεώσιμοι πόροι - [mi ananeosimi pori]
μη επιστρεφόμενη συσκευασία - [mi epistrefomeni siskefasia]
μη μέταλλα - [mi metala]
μη μεταλλικό ορυκτό - [mi metaliko orikto]
μη πτητική ουσία - [mi ptitiki usia]
μη σιδηρούχο μέταλλο - [mi sidirujo metalo]
μηδέν - [miden]
μηλιά - [milia]
μηνιγγίτιδα - [minigitida]
μηρός - [miros]
μητριά - [mitria]
μητρικό γάλα - [mitriko gala]
μητρικός - [mitrikos]
μητρόπολη - [mitropoli]
μηχάνημα καθαρισμού αέρα με ψεκασμό νερού - [mijanima kazarismu aera me psekasmo neru]
μηχάνημα φαξ - [mijanima faks]
μηχανή - [mijani]
μηχανή κοκκοποίησης - [mijani kokkopiisis]
μηχανήματα - [mijanimata]
μηχανική - [mijaniki]
μηχανική ακριβείας - [mijaniki akribias]
μηχανική περιβάλλοντος - [mijaniki peribalodos]
μηχανική των πετρωμάτων - [mijaniki ton petromaton]
μηχανικός - [mijanikos]
μηχανισμός - [mijanismos]
μηχανισμός των αντικυθήρων - [mijanismos ton adikiziron]
μηχανολογία - [mijanologia]
μηχανολογικός εξοπλισμός - [mijanologikos eksoplismos]
μηχανοτεχνίτης - [mijanotejnitis]
μηχατρονική - [mijatroniki]
μια - [mia]
μια φορά - [mia fora]
μικροβιολογία - [mikrobiologia]
μικρογραμμάριο - [mikrogramario]
μικροδιήθηση - [mikrodiizisi]
μικροηλεκτρονική - [mikroilektroniki]
μικροκλιματικό φαινόενο - [mikroklimatiko fenoeno]
μικροκλιματολογία - [mikroklimatologia]
μικροοικοσύστημα - [mikroikosistima]
μικροοργανισμός - [mikroorganismos]
μικρορύπος - [mikroripos]
μικροσκοπία - [mikroskopia]
μικροϋπολογιστής - [mikrupologistis]
μικρό - [mikro]
μικρόβιο - [mikrobio]
μικρόκλιμα - [mikroklima]
μικρόκυμα - [mikrokima]
μικρός - [mikros]
μικρόφωνο - [mikrofono]
μικτή αποτέφρωση - [mikti apotefrosi]
μικτό δάσος - [mikto dasos]
μικτό δίκτυο αποχέτευσης - [mikto diktio apojetefsis]
μιλάω - [milao]
μιλιταρισμός - [militarismos]
μιλκσέικ - [milksik]
μιλώ - [milo]
μιούζικαλ - [miusikal]
μισάνθρωπος - [misanzropos]
μισαλλόδοξος - [misalodoksos]
μισθωτήριο - [miszotirio]
μισθωτής - [miszotis]
μισθός - [miszos]
μισό - [miso]
μνήμα - [mnima]
μνήμη - [mnimi]
μνημείο - [mnimio]
μνημείο της φύσης - [mnimio tis fisis]
μοίρα - [mira]
μοιχεία - [mijia]
μολυβδαίνιο - [molibdenio]
μολυσμένη περιοχή - [molismeni perioji]
μολυσμένο έδαφος - [molismeno edafos]
μολύβι - [molibi]
μονάδα αφαλάτωσης - [monada afalatosis]
μονάδα νοικοκυριού - [monada nikokiriu]
μονάδα υδροηλεκτρικής ενέργειας - [monada idroilektrikis energias]
μονάδα χημικής βιομηχανίας - [monada jimikis biomijanias]
μονάρχης - [monarjis]
μοναδικός - [monadikos]
μοναστήρι - [monastiri]
μοναχικός - [monajikos]
μοναχοπαίδι - [monajopedi]
μονογαμία - [monogamia]
μονοξίδιο του άνθρακα - [monoksidio tu anzraka]
μονοξίδιο του αζώτου - [monoksidio tu asotu]
μονοξίδιο του θείου - [monoksidio tu ziu]
μονοπάτι - [monopati]
μονοπώλιο - [monopolio]
μοντέλο - [modelo]
μονωτικό υλικό - [monotiko iliko]
μονόδρομος - [monodromos]
μονόκερος - [monokeros]
μοριακή βιολογία - [moriaki biologia]
μορφή ηρεμίας - [morfi iremias]
μορφή της αγοράς - [morfi tis agoras]
μορφολογία - [morfologia]
μορφόκλασμα - [morfoklasma]
μοσχάρι - [mosjari]
μοσχοκάρυδο - [mosjokarido]
μοτέτο - [moteto]
μοτοποδήλατο - [motopodilato]
μοτοσυκλέτα - [motosikleta]
μοτσαρέλα - [motsarela]
μου λείπει - [mu lipi]
μουγκανίζω - [mugkaniso]
μουριά - [muria]
μουσακάς - [musakas]
μουσαμάς - [musamas]
μουσείο - [musio]
μουσική - [musiki]
μουσικό όργανο - [musiko organo]
μουσικός - [musikos]
μουστάκι - [mustaki]
μουστάρδα - [mustarda]
μουστελίδες - [mustelides]
μούρο - [muro]
μπάλα - [bala]
μπάνιο - [banio]
μπάσκετ - [basket]
μπάφος - [bafos]
μπέιζμπολ - [bisbol]
μπέικον - [bikon]
μπέμπι−σίτερ - [bebi−siter]
μπίρα - [bira]
μπαίνω - [beno]
μπακάλης - [bakalis]
μπακλαβά - [baklaba]
μπαλάντα - [balada]
μπαλαρίνα - [balarina]
μπαλκονόπορτα - [balkonoporta]
μπαλλέτο - [baleto]
μπαμπάς - [babas]
μπανανα - [banana]
μπανανιά - [banania]
μπαρμπούνι - [barbuni]
μπατ - [bat]
μπαταρία - [bataria]
μπεζ - [bes]
μπερκέλιο - [berkelio]
μπεϊμπισίτερ - [bibisiter]
μπικουτί - [bikuti]
μπιμπερον - [biberon]
μπλε - [ble]
μποζόνιο - [bosonio]
μποξ - [boks]
μποξέρ - [bokser]
μπορδέλο - [bordelo]
μπου - [bu]
μπουκαμβίλια - [bukambilia]
μπουντρούμι - [budrumi]
μπούμερανγκ - [bumerangk]
μπρίκι - [briki]
μπροστά - [brosta]
μπρόκολο - [brokolo]
μπυροκοίλι - [birokili]
μπόριο - [borio]
μυαλό - [mialo]
μυθιστοριογράφος - [mizistoriografos]
μυθιστόρημα - [mizistorima]
μυθολογία - [mizologia]
μυκητοκτόνο - [mikitoktono]
μυκητολογία - [mikitologia]
μυκόρριζα - [mikorisa]
μυοκάρδιο - [miokardio]
μυρίζω - [miriso]
μυρμήγκι - [mirmigki]
μυρμηγκοφάγος - [mirmigkofagos]
μυρωδιά - [mirodia]
μυστήριο - [mistirio]
μυστήριος - [mistirios]
μυϊκό σύστημα - [miko sistima]
μωρό - [moro]
μωσαΐκωση - [mosaΐkosi]
μωσαϊκό - [moseko]
μόδα - [moda]
μόλυβδος - [molibdos]
μόλυνση - [molinsi]
μόλυνση από κάδμιο - [molinsi apo kadmio]
μόλυνση του αίματος - [molinsi tu ematos]
μόλυνση των ζωοτροφών - [molinsi ton sootrofon]
μόνος - [monos]
μόνωση - [monosi]
μόριο - [morio]
μόρφωση - [morfosi]
μόσχευμα - [mosjefma]
μύγδαλο - [migdalo]
μύθος - [mizos]
μύκης - [mikis]
μύκητες - [mikites]
μύλος - [milos]
μύτη - [miti]
νά'σαι καλά - [nase kala]
νάρκη - [narki]
νάτριο - [natrio]
νέα τρόφιμα - [nea trofima]
νέκρωση - [nekrosi]
νέο - [neo]
νέφος - [nefos]
νήπιο - [nipio]
νήσος - [nisos]
νήστις - [nistis]
νίκη - [niki]
ναδίρ - [nadir]
ναζισμός - [nasismos]
ναζιστής - [nasistis]
ναι - [ne]
ναρκοληψία - [narkolipsia]
ναρκομανής - [narkomanis]
ναυάγιο - [nafagio]
ναυπηγική - [nafpigiki]
ναυσιπλοΐα - [nafsiploΐa]
ναυτία - [naftia]
ναυτική μηχανολογία - [naftiki mijanologia]
ναυτικό - [naftiko]
ναυτικό ατύχημα - [naftiko atijima]
ναυτικό δίκαιο - [naftiko dikeo]
ναυτικός - [naftikos]
ναός - [naos]
ναύλος - [naflos]
ναύτης - [naftis]
νεαρό άτομο - [nearo atomo]
νεκροταφείο - [nekrotafio]
νεογνά - [neogna]
νεοδύμιο - [neodimio]
νεολαία - [neolea]
νεολογισμός - [neologismos]
νεονορβηγικά - [neonorbigika]
νεοπαγής κοινότητα - [neopagis kinotita]
νεπαλικά - [nepalika]
νερό - [nero]
νερό ψύξης - [nero psiksis]
νερόψυλλοι - [neropsili]
νετρίνο - [netrino]
νετρόνιο - [netronio]
νευρικό σύστημα - [nefriko sistima]
νευρολογία - [nefrologia]
νευροτοξικότητα - [nefrotoksikotita]
νεφέλωμα - [nefeloma]
νεφρό - [nefro]
νεωτερισμός - [neoterismos]
νεότητα - [neotita]
νηματώδεις - [nimatodis]
νησί - [nisi]
νησίδα - [nisida]
νησιωτικό οικοσύστημα - [nisiotiko ikosistima]
νικέλιο - [nikelio]
νικοτίνη - [nikotini]
νιτρικό υπεροξυακετύλιο - [nitriko iperoksiaketilio]
νιτροένωση - [nitroenosi]
νιτροζαμίνη - [nitrosamini]
νιτροποίηση - [nitropiisi]
νιφάδα - [nifada]
νιόβιο - [niobio]
νοικοκυρά - [nikokira]
νοικοκυριό - [nikokirio]
νομάδας - [nomadas]
νομικά - [nomika]
νομική - [nomiki]
νομική βάση - [nomiki basi]
νομική διαδικασία - [nomiki diadikasia]
νομική θεωρία - [nomiki zeoria]
νομική πράξη - [nomiki praksi]
νομικό κείμενο - [nomiko kimeno]
νομιμοποιώ - [nomimopio]
νομοθέτης - [nomozetis]
νομοθεσία - [nomozesia]
νομοθεσία-πλαίσιο - [nomozesia-plesio]
νομοθετική αρμοδιότητα - [nomozetiki armodiotita]
νομοθετική αρχή - [nomozetiki arji]
νομοθετική διαδικασία - [nomozetiki diadikasia]
νομοθετικό σώμα - [nomozetiko soma]
νομολογία - [nomologia]
νομπέλιο - [nobelio]
νονός - [nonos]
νορβηγικά - [norbigika]
νορβηγικός - [norbigikos]
νοσηρός - [nosiros]
νοσοκομείο - [nosokomio]
νοσοκόμα - [nosokoma]
νοσταλγία - [nostalgia]
νοσταλγός - [nostalgos]
νους - [nus]
ντίσκο - [disko]
νταβατζής - [dabatsis]
ντανταϊσμός - [dadesmos]
νταρμστάντιο - [darmstadio]
ντεσιμπέλ - [desibel]
ντομάτα - [domata]
ντουζιέρα - [dusiera]
ντουλάπα - [dulapa]
ντούμπνιο - [dubnio]
ντροπή - [dropi]
ντροπαλός - [dropalos]
νυχτερίδα - [nijterida]
νόθευση - [nozefsi]
νόμισμα - [nomisma]
νόμος - [nomos]
νόσος - [nosos]
νόσος αλτσχάιμερ - [nosos altsjemer]
νόσος του πάρκινσον - [nosos tu parkinson]
νότος - [notos]
νύμφη - [nimfi]
νύφη - [nifi]
νύχι - [niji]
νύχτα - [nijta]
ξάδερφος - [ksaderfos]
ξένο - [kseno]
ξένος - [ksenos]
ξέρα - [ksera]
ξέρω - [ksero]
ξίφος - [ksifos]
ξαδέρφη - [ksaderfi]
ξαναζεσταίνω - [ksanasesteno]
ξαφνιασμένος - [ksafniasmenos]
ξαφνικά - [ksafnika]
ξαφνικός - [ksafnikos]
ξεβουλωτήρι - [ksebulotiri]
ξεκουράζομαι - [ksekurasome]
ξενικό είδος - [kseniko idos]
ξενοβιοτική ουσία - [ksenobiotiki usia]
ξενοδοχείο - [ksenodojio]
ξενοδοχειακός κλάδος - [ksenodojiakos klados]
ξενοφοβία - [ksenofobia]
ξεπροβάλλω - [kseprobalo]
ξερνάω - [ksernao]
ξεσκούφωτος - [kseskufotos]
ξεχνώ - [ksejno]
ξηρά - [ksira]
ξηρή αχλύς - [ksiri ajlis]
ξηρασία - [ksirasia]
ξηρική καλλιέργεια - [ksiriki kaliergia]
ξηρός - [ksiros]
ξινός - [ksinos]
ξιφίας - [ksifias]
ξιφασκία - [ksifaskia]
ξυλάνθρακας - [ksilanzrakas]
ξυλεία - [ksilia]
ξυλόφωνο - [ksilofono]
ξυνό - [ksino]
ξυπνητήρι - [ksipnitiri]
ξυπνώ - [ksipno]
ξυρίζομαι - [ksirisome]
ξυρίζω - [ksiriso]
ξύδι - [ksidi]
ξύλινος - [ksilinos]
ξύλο - [ksilo]
ο - [o]
ο νοών νοείτω - [o noon noito]
οίκος ανοχής - [ikos anojis]
ογδόντα οκτώ - [ogdoda okto]
ογκολογία - [ogkologia]
ογχοκερκίαση - [ogjokerkiasi]
οδηγία - [odigia]
οδηγός - [odigos]
οδική ασφάλεια - [odiki asfalia]
οδική κυκλοφορία - [odiki kikloforia]
οδική πινακίδα - [odiki pinakida]
οδική πρόσβαση - [odiki prosbasi]
οδικό δίκτυο - [odiko diktio]
οδογέφυρα - [odogefira]
οδοκαθαρισμός - [odokazarismos]
οδοντίατρος - [ododiatros]
οδοντιατρική - [ododiatriki]
οδοντιατρικός - [ododiatrikos]
οδοντικό φατνίο - [ododiko fatnio]
οδοντογλυφίδα - [ododoglifida]
οδοντωτός τροχός - [ododotos trojos]
οδοντόβουρτσα - [ododoburtsa]
οδοντόγναθα - [ododognaza]
οδοντόκρεμα - [ododokrema]
οδοντόπαστα - [ododopasta]
οζονοποίηση - [osonopiisi]
οθόνη - [ozoni]
οθόνη αφής - [ozoni afis]
οικιακά απορρίμματα - [ikiaka aporimata]
οικιακή συσκευή - [ikiaki siskefi]
οικισμός ανθρώπων - [ikismos anzropon]
οικιστική περιοχή - [ikistiki perioji]
οικιστικός σχεδιασμός - [ikistikos sjediasmos]
οικογένεια - [ikogenia]
οικογενειακή κατάσταση - [ikogeniaki katastasi]
οικογενειακή μονάδα - [ikogeniaki monada]
οικογενειακό δίκαιο - [ikogeniako dikeo]
οικογενειακός προγραμματισμός - [ikogeniakos programatismos]
οικοδομή - [ikodomi]
οικοδομήσιμη γη - [ikodomisimi gi]
οικοδομική άδεια - [ikodomiki adia]
οικοδομική τεχνολογία - [ikodomiki tejnologia]
οικοδόμημα - [ikodomima]
οικοδόμηση - [ikodomisi]
οικοζώνη - [ikosoni]
οικολογία - [ikologia]
οικολογία του ανθρώπου - [ikologia tu anzropu]
οικολογία του εδάφους - [ikologia tu edafus]
οικολογία του τοπίου - [ikologia tu topiu]
οικολογία των πληθυσμών - [ikologia ton plizismon]
οικολογία των πόλεων - [ikologia ton poleon]
οικολογία των φυτών - [ikologia ton fiton]
οικολογία υγροτόπων - [ikologia igrotopon]
οικολογική ανισότητα - [ikologiki anisotita]
οικολογική ισορροπία - [ikologiki isoropia]
οικολογική καταστροφή - [ikologiki katastrofi]
οικολογική παιδιατρική - [ikologiki pediatriki]
οικολογική προσαρμογή - [ikologiki prosarmogi]
οικολογική φωλεά - [ikologiki folea]
οικολογικό μουσείο - [ikologiko musio]
οικολογικό σήμα της εκ - [ikologiko sima tis ek]
οικολογικός τουρισμός - [ikologikos turismos]
οικονομία - [ikonomia]
οικονομία της αγοράς - [ikonomia tis agoras]
οικονομία της ενέργειας - [ikonomia tis energias]
οικονομετρία - [ikonometria]
οικονομικά - [ikonomika]
οικονομικές επιστήμες - [ikonomikes epistimes]
οικονομική ανάλυση - [ikonomiki analisi]
οικονομική ανάπτυξη - [ikonomiki anaptiksi]
οικονομική βιωσιμότητα - [ikonomiki biosimotita]
οικονομική γεωγραφία - [ikonomiki geografia]
οικονομική δραστηριότητα - [ikonomiki drastiriotita]
οικονομική ζώνωση - [ikonomiki sonosi]
οικονομική θεωρία - [ikonomiki zeoria]
οικονομική μεγέθυνση - [ikonomiki megezinsi]
οικονομική περιοχή - [ikonomiki perioji]
οικονομική πολιτική - [ikonomiki politiki]
οικονομική των επιχειρήσεων - [ikonomiki ton epijiriseon]
οικονομικό μέσο - [ikonomiko meso]
οικονομικό σύστημα - [ikonomiko sistima]
οικονομικός ανταγωνισμός - [ikonomikos adagonismos]
οικονομικός τομέας - [ikonomikos tomeas]
οικονομολογία - [ikonomologia]
οικοσύστημα - [ikosistima]
οικοσύστημα σε γλυκά ύδατα - [ikosistima se glika idata]
οικοσύστημα τροπικού δάσους - [ikosistima tropiku dasus]
οικοτοξικολογία - [ikotoksikologia]
οικοτοξικότητα - [ikotoksikotita]
οικοτουρισμός - [ikoturismos]
οικοφυσιολογία - [ikofisiologia]
οικοϊσορροπία - [ikisoropia]
οικότοπος - [ikotopos]
οικότυπος - [ikotipos]
οινόπνευμα - [inopnefma]
οισοφάγος - [isofagos]
οκρόσκα - [okroska]
οκτάγωνο - [oktagono]
οκτάπους - [oktapus]
οκτώ - [okto]
ολική παράμετρος - [oliki parametros]
ολικό φορτίο - [oliko fortio]
ολικός οργανικός άνθρακας - [olikos organikos anzrakas]
ολλανδικά - [olandika]
ομάδα - [omada]
ομάδα δράσης - [omada drasis]
ομάδα καταναλωτών - [omada katanaloton]
ομάδα πίεσης - [omada piesis]
ομάδα-στόχος - [omada-stojos]
ομίχλη - [omijli]
ομβρόφιλο δάσος - [ombrofilo dasos]
ομιλία - [omilia]
ομοίωμα - [omioma]
ομογενής - [omogenis]
ομοιογενής - [omiogenis]
ομοιοπαθητική - [omiopazitiki]
ομοιόμορφος - [omiomorfos]
ομοσπονδία - [omospondia]
ομοσπονδιακή κυβέρνηση - [omospondiaki kibernisi]
ομοφοβία - [omofobia]
ομοφυλοφιλία - [omofilofilia]
ομόφωνος - [omofonos]
ονειρευτώ - [onirefto]
ονειροπόληση - [oniropolisi]
ονοματολογία - [onomatologia]
οντογένεση - [odogenesi]
οντότητα - [odotita]
οξέα - [oksea]
οξίδια - [oksidia]
οξίδιο του αζώτου - [oksidio tu asotu]
οξίδιο του θείου - [oksidio tu ziu]
οξίδωση - [oksidosi]
οξίνιση - [oksinisi]
οξίνιση του εδάφους - [oksinisi tu edafus]
οξεία ρινοφαρυγγίτιδα - [oksia rinofarigitida]
οξιά - [oksia]
οξιδοαναγωγή - [oksidoanagogi]
οξιδωτικό υλικό - [oksidotiko iliko]
οξικό οξύ - [oksiko oksi]
οξυγόνο - [oksigono]
οξυγόνωση - [oksigonosi]
οξυδερκής - [oksiderkis]
οξύμωρο - [oksimoro]
οξύτητα - [oksitita]
οξύτητα ακοής - [oksitita akois]
οπλή - [opli]
οπληφόρα - [oplifora]
οπλισμός - [oplismos]
οπλοστάσιο - [oplostasio]
οπτάνθρακας - [optanzrakas]
οπτικοακουστικός τομέας - [optikoakustikos tomeas]
οπτικός - [optikos]
οπτόπλινθος - [optoplinzos]
οπωροφόρο δέντρο - [oporoforo dedro]
οργάνωση εργασιών - [organosi ergasion]
οργανικά απόβλητα - [organika apoblita]
οργανικές ουσίες - [organikes usies]
οργανική χημεία - [organiki jimia]
οργανική ύλη - [organiki ili]
οργανικό άζωτο - [organiko asoto]
οργανικός - [organikos]
οργανικός άνθρακας - [organikos anzrakas]
οργανικός διαλύτης - [organikos dialitis]
οργανισμός - [organismos]
οργανισμός γλυκέων υδάτων - [organismos glikeon idaton]
οργανισμός δοκιμασίας - [organismos dokimasias]
οργανισμός του εδάφους - [organismos tu edafus]
οργανοαζωτούχος ένωση - [organoasotujos enosi]
οργανοαλογονούχος ένωση - [organoalogonujos enosi]
οργανοθειούχος ένωση - [organoziujos enosi]
οργανοληπτική ιδιότητα - [organoliptiki idiotita]
οργανομεταλλική ένωση - [organometaliki enosi]
οργανοοξυγονούχος ένωση - [organooksigonujos enosi]
οργανοπαίκτης - [organopektis]
οργανοπυριτική ένωση - [organopiritiki enosi]
οργανοφωσφορική ένωση - [organofosforiki enosi]
οργανοχλωριούχος ένωση - [organojloriujos enosi]
οργασμός - [orgasmos]
ορείχαλκος - [orijalkos]
ορειβασία - [oribasia]
ορειβατικό καταφύγειο - [oribatiko katafigio]
ορεινή περιοχή - [orini perioji]
ορεινό δάσος - [orino dasos]
ορεινό κλίμα - [orino klima]
ορεκτικό - [orektiko]
ορεογραφία - [oreografia]
ορθογραφία - [orzografia]
ορθογώνιο παραλληλόγραμμο - [orzogonio paralilogramo]
ορθοδοντική - [orzododiki]
ορθόπτερα - [orzoptera]
οριακό στρώμα - [oriako stroma]
οριγκάμι - [origkami]
ορισμός - [orismos]
ορμίσκος - [ormiskos]
ορμητικός - [ormitikos]
ορμόνη - [ormoni]
ορνιθοκομία - [ornizokomia]
ορνιθολογία - [ornizologia]
ορνιθοπανίδα - [ornizopanida]
ορνιθόμορφα - [ornizomorfa]
οροθετικό ζώο - [orozetiko soo]
ορολογία - [orologia]
οροσειρά - [orosira]
ορτύκι - [ortiki]
ορυκτά απόβλητα - [orikta apoblita]
ορυκτέλαιο - [orikteleo]
ορυκτή ίνα - [orikti ina]
ορυκτολογία - [oriktologia]
ορυκτολογία εδάφους - [oriktologia edafus]
ορυκτοποίηση - [oriktopiisi]
ορυκτό - [orikto]
ορυκτό βελτιωτικό - [orikto beltiotiko]
ορυκτό καύσιμο - [orikto kafsimo]
ορυχείο - [orijio]
ορφανός - [orfanos]
ορχήστρα - [orjistra]
οσμή - [osmi]
οσμομετρία - [osmometria]
οστεοπόρωση - [osteoporosi]
οστρακοκαλλιέργεια - [ostrakokaliergia]
οστρακόδερο - [ostrakodero]
οστό - [osto]
οσφραίνομαι - [osfrenome]
ουίκι - [uiki]
ουίσκι - [uiski]
ουαλλικά - [ualika]
ουγγρικά - [ugrika]
ουδέτερος - [udeteros]
ουδετεροποίηση - [udeteropiisi]
ουκρανικά - [ukranika]
ουλή - [uli]
ουλίτιδα - [ulitida]
ουρά - [ura]
ουράνια - [urania]
ουράνιο - [uranio]
ουράνιο τόξο - [uranio tokso]
ουρανοξύστης - [uranoksistis]
ουρανός - [uranos]
ουροδελή - [urodeli]
ουρώ - [uro]
ουσιαστικόν - [usiastikon]
οφίδια - [ofidia]
οφειλέτης - [ofiletis]
οχτώ - [ojto]
ούρα - [ura]
πάγος - [pagos]
πάθηση - [pazisi]
πάνα - [pana]
πάνθηρας - [panziras]
πάντα - [pada]
πάντοτε - [padote]
πάπια - [papia]
πάππος - [papos]
πάπυρος - [papiros]
πάρκο - [parko]
πάρκο αναψυχής - [parko anapsijis]
πάσσαλος - [pasalos]
πάστορας - [pastoras]
πάτωμα - [patoma]
πέμπτο - [pebto]
πέναλτι - [penalti]
πέντε - [pede]
πέος - [peos]
πέργκολα - [pergkola]
πέρδικα - [perdika]
πέτρα - [petra]
πέτρωμα - [petroma]
πήδημα - [pidima]
πήξη - [piksi]
πίδακας - [pidakas]
πίεση - [piesi]
πίεση ατμού - [piesi atmu]
πίνακας - [pinakas]
πίνακας περιεχομένων - [pinakas periejomenon]
πίνω - [pino]
πίσσα - [pisa]
πίσω πόρτα - [piso porta]
πίτσα - [pitsa]
πα πα - [pa pa]
παίγνιο - [pegnio]
παίκτης - [pektis]
παίρνω - [perno]
παίρνω πρωινό - [perno proino]
παγίδευση - [pagidefsi]
παγανισμός - [paganismos]
παγετωνολογία - [pagetonologia]
παγετός - [pagetos]
παγετώνας - [pagetonas]
παγκρεατίτιδα - [pagkreatitida]
παγοδρομία - [pagodromia]
παγοθραυστικό - [pagozrafstiko]
παγωτό - [pagoto]
παγόβουνο - [pagobuno]
παγόνι - [pagoni]
παγώνι - [pagoni]
παθογόνο - [pazogono]
παθογόνος οργανισμός - [pazogonos organismos]
παθολογία - [pazologia]
παιδί - [pedi]
παιδίατρος - [pediatros]
παιδαγωγική - [pedagogiki]
παιδεία - [pedia]
παιδεραστής - [pederastis]
παιδιάστικος - [pediastikos]
παιδοφιλία - [pedofilia]
παιχνίδι - [pejnidi]
παιχνιδιάρης - [pejnidiaris]
παλάτι - [palati]
παλέτα - [paleta]
παλίρροια - [paliria]
παλαιοκλιματολογία - [paleoklimatologia]
παλαιοντολογία - [paleodologia]
παλαιοοικολογία - [paleoikologia]
παλιρροϊκά ύδατα - [palirika idata]
παλλάδιο - [paladio]
παμφάγος - [pamfagos]
πανί - [pani]
πανίδα - [panida]
πανδοχείο - [pandojio]
πανεπιστήμιο - [panepistimio]
πανούργος - [panurgos]
παντελόνι - [padeloni]
παντού - [padu]
παντρεύομαι - [padrefome]
πανώλη - [panoli]
πανώλης - [panolis]
παπάς - [papas]
παπί - [papi]
παπαγάλος - [papagalos]
παπαδίτσα - [papaditsa]
παπαρούνα - [paparuna]
παπούτσι - [paputsi]
παππούς - [papus]
παπυρολογία - [papirologia]
παράβαση - [parabasi]
παράγοντας τερατογένεσης - [paragodas teratogenesis]
παράδειγμα - [paradigma]
παράδεισος - [paradisos]
παράδοση - [paradosi]
παράδοση επί αντικαταβολή - [paradosi epi adikataboli]
παράθυρο - [paraziro]
παράκτια αλιεία - [paraktia aliia]
παράκτια ύδατα - [paraktia idata]
παράκτιος - [paraktios]
παράλιος - [paralios]
παράλληλος - [paralilos]
παράμεσος - [paramesos]
παράμετροι - [parametri]
παράνυμφος - [paranimfos]
παράξενος - [paraksenos]
παράσιτα των καλλιεργειών - [parasita ton kaliergion]
παράσιτο - [parasito]
παράσταση - [parastasi]
παράφορος - [paraforos]
παρίσταμαι - [paristame]
παραβίαση - [parabiasi]
παραγγελία - [paragelia]
παραγραφή - [paragrafi]
παραγωγή ενέργειας - [paragogi energias]
παραγωγή ηλεκτρισμού - [paragogi ilektrismu]
παραγωγή κτηνοτροφικών προϊόντων - [paragogi ktinotrofikon priodon]
παραδοσιακή αρχιτεκτονική - [paradosiaki arjitektoniki]
παραδοσιακή ιατρική φροντίδα - [paradosiaki iatriki frodida]
παρακαλώ - [parakalo]
παρακμή - [parakmi]
παρακολουθώ - [parakoluzo]
παρακολούθηση - [parakoluzisi]
παρακολούθηση ακτινοβολιών - [parakoluzisi aktinobolion]
παρακολούθηση κυκλοφορίας - [parakoluzisi kikloforias]
παρακολούθηση του καιρού - [parakoluzisi tu keru]
παραλήπτης - [paraliptis]
παραλία - [paralia]
παραμύθι - [paramizi]
παραπληγία - [parapligia]
παραπροϊόν - [paraprion]
παρασιτολογία - [parasitologia]
παραχώρηση - [parajorisi]
παραχώρηση γης - [parajorisi gis]
παρειδωλία - [paridolia]
παρελθόν - [parelzon]
παρεμβολή - [paremboli]
παρενέργεια - [parenergia]
παρθένα - [parzena]
παρθενογένεση - [parzenogenesi]
παροιμία - [parimia]
παρουσίαση - [parusiasi]
παροχέας υπηρεσιών διαδικτύου - [parojeas ipiresion diadiktiu]
παροχή - [paroji]
παροχή αερίου - [paroji aeriu]
παροχή θερμότητας - [paroji zermotitas]
παροχή νερού - [paroji neru]
παρυφή - [parifi]
παρωτίτιδα - [parotitida]
πασκάλ - [paskal]
παστινάκι - [pastinaki]
πασχαλίτσα - [pasjalitsa]
πασχαλιά - [pasjalia]
πατ - [pat]
πατάτα - [patata]
πατέρας - [pateras]
πατατοσαλάτα - [patatosalata]
πατούσα - [patusa]
πατριαρχία - [patriarjia]
πατρικός - [patrikos]
πατριός - [patrios]
πατροκτονία - [patroktonia]
πατροκτόνος - [patroktonos]
παχυσαρκία - [pajisarkia]
παχύσαρκος - [pajisarkos]
πείνα - [pina]
πείραμα - [pirama]
πείραμα πεδίου - [pirama pediu]
πεδίο - [pedio]
πεδίο ροής - [pedio rois]
πεδιάδα - [pediada]
πεδινή έκταση - [pedini ektasi]
πεδόσφαιρα - [pedosfera]
πεζογραφία - [pesografia]
πεζοδρόμιο - [pesodromio]
πεζόδρομος - [pesodromos]
πεθαίνω - [pezeno]
πεθερός - [pezeros]
πειραματική μελέτη - [piramatiki meleti]
πειραματικό έργο - [piramatiko ergo]
πειραματόζωο - [piramatosoo]
πελάτης - [pelatis]
πελαργός - [pelargos]
πελματοβάμον ζώο - [pelmatobamon soo]
πενήντα - [penida]
πενήντα έν - [penida en]
πενήντα έξ - [penida eks]
πενήντα δύο - [penida dio]
πενήντα εννέα - [penida enea]
πενήντα επτά - [penida epta]
πενήντα οκτώ - [penida okto]
πενήντα πέντε - [penida pede]
πενήντα τέσσαρες - [penida tesares]
πενήντα τρείς - [penida tris]
πεντακόσια - [pedakosia]
πενταχλωροφαινόλη - [pedajlorofenoli]
πεποίθηση - [pepizisi]
πεπόνι - [peponi]
περίεργος - [periergos]
περίοδος - [periodos]
περίπατος - [peripatos]
περίφυτο - [perifito]
περιέργεια - [periergia]
περιήλιο - [periilio]
περιαστικός χώρος - [periastikos joros]
περιβάλλον - [peribalon]
περιβάλλον διαβίωσης - [peribalon diabiosis]
περιβάλλον εσωτερικών χώρων - [peribalon esoterikon joron]
περιβαλλοντικές επιπτώσεις - [peribalodikes epiptosis]
περιβαλλοντική άδεια - [peribalodiki adia]
περιβαλλοντική έκθεση - [peribalodiki ekzesi]
περιβαλλοντική έρευνα - [peribalodiki erefna]
περιβαλλοντική αγωγή - [peribalodiki agogi]
περιβαλλοντική ασφάλεια - [peribalodiki asfalia]
περιβαλλοντική δεοντολογία - [peribalodiki deodologia]
περιβαλλοντική ελεγκτική - [peribalodiki elegktiki]
περιβαλλοντική επένδυση - [peribalodiki ependisi]
περιβαλλοντική επιδότηση - [peribalodiki epidotisi]
περιβαλλοντική ευθύνη - [peribalodiki efzini]
περιβαλλοντική ιατρική - [peribalodiki iatriki]
περιβαλλοντική ιθαγένεια - [peribalodiki izagenia]
περιβαλλοντική ιστορία - [peribalodiki istoria]
περιβαλλοντική νομοθεσία - [peribalodiki nomozesia]
περιβαλλοντική ορολογία - [peribalodiki orologia]
περιβαλλοντική πολιτική - [peribalodiki politiki]
περιβαλλοντική τεχνική - [peribalodiki tejniki]
περιβαλλοντική χημεία - [peribalodiki jimia]
περιβαλλοντική ψυχολογία - [peribalodiki psijologia]
περιβαλλοντικό κόστος - [peribalodiko kostos]
περιβαλλοντικό ποινικό δίκαιο - [peribalodiko piniko dikeo]
περιβαλλοντικό πρόγραμμα - [peribalodiko programa]
περιβαλλοντικός βανδαλισμός - [peribalodikos bandalismos]
περιβαλλοντικός πόλεμος - [peribalodikos polemos]
περιβολή - [periboli]
περιδινητής - [peridinitis]
περιεκτικότητα σε αλουμίνιο - [periektikotita se aluminio]
περιεκτικότητα σε ασβέστιο - [periektikotita se asbestio]
περιεκτικότητα σε οξυγόνο - [periektikotita se oksigono]
περιορισμός του εμπορίου - [periorismos tu eboriu]
περιοχή - [perioji]
περιοχή αγρανάπαυσης - [perioji agranapafsis]
περιοχή ανάπτυξης - [perioji anaptiksis]
περιοχή αναπαραγωγής - [perioji anaparagogis]
περιοχή διέλευσης - [perioji dielefsis]
περιοχή δόμησης - [perioji domisis]
περιοχή εξαπλώσεως - [perioji eksaploseos]
περιοχή καθαρού αέρα - [perioji kazaru aera]
περιοχή μικτής χρήσης - [perioji miktis jrisis]
περιοχή προστασίας υδατικών πόρων - [perioji prostasias idatikon poron]
περιοχή της ανταρκτικής - [perioji tis adarktikis]
περιοχή της καραϊβικής - [perioji tis karebikis]
περιοχή της μεσογείου - [perioji tis mesogiu]
περιοχή φωλιάσματος - [perioji foliasmatos]
περιπλανώμενος - [periplanomenos]
περιστέρι - [peristeri]
περιστερώνας - [peristeronas]
περιστροφική κάμινος - [peristrofiki kaminos]
περισυλλογή - [perisilogi]
περιφέρεια - [periferia]
περιφερειακή πολιτική - [periferiaki politiki]
περπατάω-ώ - [perpatao-o]
περσικά - [persika]
πεσσιμισμός - [pesimismos]
πεταλούδες - [petaludes]
πετοσφαίριση - [petosferisi]
πετρέλαιο - [petreleo]
πετρέλαιο εξωτερικής καύσης - [petreleo eksoterikis kafsis]
πετρέλαιο ντίζελ - [petreleo disel]
πετρελαιοκηλίδα - [petreleokilida]
πετρελαιοκινητήρας - [petreleokinitiras]
πετρελαιοφόρο - [petreleoforo]
πετρελαϊκή ρύπανση - [petreleki ripansi]
πετροχημική βιομηχανία - [petrojimiki biomijania]
πετροχημική ουσία - [petrojimiki usia]
πετσέτα - [petseta]
πεύκο - [pefko]
πηγάδι - [pigadi]
πηγή - [pigi]
πηγή ενέργειας - [pigi energias]
πηγούνι - [piguni]
πηδώ - [pido]
πηρούνι - [piruni]
πιάνο - [piano]
πιάτο - [piato]
πιγγ πογγ - [pig pog]
πιεζοηλεκτρισμός - [piesoilektrismos]
πιεστήριο - [piestirio]
πικρός - [pikros]
πιλότος - [pilotos]
πινάκι - [pinaki]
πινέζα - [pinesa]
πινγκ πονγκ - [pingk pongk]
πινγκ πόνγκ - [pingk pongk]
πινγκ-πονγκ - [pingk-pongk]
πινγκουίνος - [pingkuinos]
πιπέρι - [piperi]
πιπίλα - [pipila]
πιπεριά - [piperia]
πιπερόρριζα - [piperorisa]
πιρούνι - [piruni]
πισούχος άμμος - [pisujos amos]
πισσούχος σχιστόλιθος - [pisujos sjistolizos]
πιστεύω - [pistefo]
πιστολάκι - [pistolaki]
πιστοποίηση - [pistopiisi]
πιστοποίηση της ποιότητας - [pistopiisi tis piotitas]
πιστωτική διευκόλυνση - [pistotiki diefkolinsi]
πιστωτική κάρτα - [pistotiki karta]
πιόνι - [pioni]
πλάτη - [plati]
πλάτωμα - [platoma]
πλέγμα - [plegma]
πλέγμα σάρωσης - [plegma sarosis]
πλένω - [pleno]
πλήρης - [pliris]
πλίνθωμα - [plinzoma]
πλαίσιο - [plesio]
πλαγιά - [plagia]
πλαγκτόν - [plagkton]
πλακούντας διήθησης - [plakudas diizisis]
πλανήτης - [planitis]
πλανήτης νάνος - [planitis nanos]
πλαστικά απορρίμματα - [plastika aporimata]
πλατεία - [platia]
πλατύπους - [platipus]
πλατύφυλλο δέντρο - [platifilo dedro]
πλεόνασμα - [pleonasma]
πλεύση - [plefsi]
πληγή - [pligi]
πληγείσα ζώνη - [pligisa soni]
πληθυσμιακή δυναμική - [plizismiaki dinamiki]
πληθυσμιακή κίνηση - [plizismiaki kinisi]
πληθυσμός - [plizismos]
πληθωρισμός - [plizorismos]
πληκτικός - [pliktikos]
πληκτρολόγιο - [pliktrologio]
πλημυρίδα - [plimirida]
πλημύρα - [plimira]
πληροφορία - [pliroforia]
πληροφορίαίες - [pliroforiees]
πληροφορίες για το προϊόν - [plirofories gia to prion]
πληροφοριακή υποδομή - [pliroforiaki ipodomi]
πληροφοριακό σύστημα - [pliroforiako sistima]
πληροφορική - [pliroforiki]
πληροφόρηση - [pliroforisi]
πλινθοδομή - [plinzodomi]
πλοήγηση - [ploigisi]
πλοίο - [plio]
πλουραλισμός - [pluralismos]
πλουτώνιο - [plutonio]
πλούσιος - [plusios]
πλούτος - [plutos]
πλωτή οδός - [ploti odos]
πλύση - [plisi]
πνευματική ιδιοκτησία - [pnefmatiki idioktisia]
πνευμοκονίωση - [pnefmokoniosi]
πνευμονία - [pnefmonia]
πνευμονική κυψελίδα - [pnefmoniki kipselida]
πνευμονική πάθηση - [pnefmoniki pazisi]
πνευμονικό νόσημα - [pnefmoniko nosima]
πνεύμονας - [pnefmonas]
ποάνθρακας - [poanzrakas]
ποδάγρα - [podagra]
ποδήλατο - [podilato]
ποδηλατώ - [podilato]
ποδόσφαιρο - [podosfero]
ποζιτρόνιο - [positronio]
ποιητής - [piitis]
ποιμένας - [pimenas]
ποιμήν - [pimin]
ποινικές ρήτρες - [pinikes ritres]
ποινική δικονομία - [piniki dikonomia]
ποινική κύρωση - [piniki kirosi]
ποινικό δίκαιο - [piniko dikeo]
ποιοτική προδιαγραφή για τη στέγαση - [piotiki prodiagrafi gia ti stegasi]
ποιοτικός έλεγχος - [piotikos elegjos]
ποιοτικός στόχος - [piotikos stojos]
ποιότητα ζωής - [piotita sois]
ποιότητα του αέρα - [piotita tu aera]
ποιότητα του εδάφους - [piotita tu edafus]
ποιότητα του περιβάλλοντος - [piotita tu peribalodos]
ποιότητα των τροφίμων - [piotita ton trofimon]
ποιότητα των υδάτων - [piotita ton idaton]
ποιότητα των υπογείων υδάτων - [piotita ton ipogion idaton]
πολίτης - [politis]
πολεμικές τέχνες - [polemikes tejnes]
πολεμοχαρής - [polemojaris]
πολεοδομία - [poleodomia]
πολεοδομική μελέτη - [poleodomiki meleti]
πολική περιοχή - [poliki perioji]
πολικό οικοσύστημα - [poliko ikosistima]
πολιορκία - [poliorkia]
πολιτεία - [politia]
πολιτικά - [politika]
πολιτική - [politiki]
πολιτική αερίων - [politiki aerion]
πολιτική αμοιβών - [politiki amibon]
πολιτική ανταλλαγής - [politiki adalagis]
πολιτική ασφάλεια - [politiki asfalia]
πολιτική γεωγραφία - [politiki geografia]
πολιτική για την διατήρηση της φύσης - [politiki gia tin diatirisi tis fisis]
πολιτική για τον κατασκευαστικό τομέα - [politiki gia ton kataskefastiko tomea]
πολιτική εξουσία - [politiki eksusia]
πολιτική μεταφορών - [politiki metaforon]
πολιτική οικολογία - [politiki ikologia]
πολιτική οργάνωση - [politiki organosi]
πολιτική τιμών - [politiki timon]
πολιτικό δόγμα - [politiko dogma]
πολιτικό κόμμα - [politiko koma]
πολιτισμός - [politismos]
πολιτιστική κληρονομιά - [politistiki klironomia]
πολλαπλασιασμός των φυτών - [polaplasiasmos ton fiton]
πολτοποίηση - [poltopiisi]
πολτός - [poltos]
πολυήμερος - [poliimeros]
πολυβρομιωμένο διφαινύλιο - [polibromiomeno difenilio]
πολυβόλο - [polibolo]
πολυγαμία - [poligamia]
πολυεθνική επιχείρηση - [poliezniki epijirisi]
πολυθρόνα - [polizrona]
πολυκατοικία - [polikatikia]
πολυκυκλικός αρωματικός υδρογονάνθρακας - [polikiklikos aromatikos idrogonanzrakas]
πολυκυκλικός υδρογονάνθρακας - [polikiklikos idrogonanzrakas]
πολυμερές - [polimeres]
πολυμερής συμφωνία - [polimeris simfonia]
πολυμερισμός - [polimerismos]
πολυτέλεια - [politelia]
πολυφωνία - [polifonia]
πολυχλωρίδιο του βινυλίου - [polijloridio tu biniliu]
πολυχλωριωμένο διβενζοφουράνιο - [polijloriomeno dibensofuranio]
πολυχλωριωμένο διφαινύλιο - [polijloriomeno difenilio]
πολυχλωριωμένο τερφαινύλιο - [polijloriomeno terfenilio]
πολυχλωροδιβενζο-π-διοξίνη - [polijlorodibenso-p-dioksini]
πολφός - [polfos]
πολωνικά - [polonika]
πολύγλωσσος - [poliglosos]
πολύγωνο - [poligono]
πολύεδρον - [poliedron]
πολύμηνος - [poliminos]
πολύχρονος - [polijronos]
πολώνιο - [polonio]
πονοκέφαλος - [ponokefalos]
ποντίκι - [podiki]
πονόλαιμος - [ponolemos]
πορεία - [poria]
πορνεία - [pornia]
πορνογραφία - [pornografia]
πορνογραφικός - [pornografikos]
πορσελάνη - [porselani]
πορτογαλικά - [portogalika]
πορτοκάλι - [portokali]
πορτοκαλής - [portokalis]
πορτοκαλί - [portokali]
πορτοφόλι - [portofoli]
πορφυρό - [porfiro]
ποσειδώνιο - [posidonio]
ποσοστό - [pososto]
ποσό - [poso]
ποσότητα - [posotita]
ποτάμια ύδατα - [potamia idata]
ποτάμιες μεταφορές - [potamies metafores]
ποτέ - [pote]
ποτήρι - [potiri]
ποτήρι κρασιού - [potiri krasiu]
ποταμός - [potamos]
ποτό - [poto]
πουθενά - [puzena]
πουλάρι - [pulari]
πουλί - [puli]
πουλερικά - [pulerika]
πουρίνη - [purini]
πού - [pu]
πούλπα - [pulpa]
πούπουλα - [pupula]
πούπουλο - [pupulo]
πράξεις - [praksis]
πράσινη επανάσταση - [prasini epanastasi]
πράσινο - [prasino]
πράσινο κύμα - [prasino kima]
πράσινο λαχανικό - [prasino lajaniko]
πράσινος - [prasinos]
πράσο - [praso]
πρέσα - [presa]
πρίγκιπας - [prigkipas]
πρίζα - [prisa]
πρίον - [prion]
πραγματικότητα - [pragmatikotita]
πρανές - [pranes]
πρασινοδύμιο - [prasinodimio]
πρασινωπός - [prasinopos]
πρατήριο καυσίμων - [pratirio kafsimon]
πρεσβευτής - [presbeftis]
πριαπισμός - [priapismos]
πριγκήπισσα - [prigkipisa]
πριμ - [prim]
πριν - [prin]
πριονίδι - [prionidi]
πριόνι - [prioni]
προάστιο - [proastio]
προίκα - [prika]
προαγορά - [proagora]
προβολέας - [proboleas]
προβολή - [proboli]
προβοσκιδοειδή - [proboskidoidi]
προγεροντική άνοια - [progerodiki ania]
προγευματίζω - [progefmatiso]
προγραμματιστής - [programatistis]
προδιαγεγραμμένα όρια εκπομπών - [prodiagegramena oria ekpobon]
προδιαγραφές ασφαλείας - [prodiagrafes asfalias]
προδιαγραφή - [prodiagrafi]
προδιαγραφή προϊόντος - [prodiagrafi priodos]
προδιαγραφή πυρασφάλειας - [prodiagrafi pirasfalias]
προδοσία - [prodosia]
προειδοποίηση - [proidopiisi]
προηγούμαι - [proigume]
προκαταρκτική διαδικασία - [prokatarktiki diadikasia]
προκατασκευασμένο κτήριο - [prokataskefasmeno ktirio]
προκλητικός - [proklitikos]
προμήθεια - [promizia]
προνύμφη - [pronimfi]
προορισμός μεταφοράς - [proorismos metaforas]
προπάνιο - [propanio]
προπονητής - [proponitis]
προς - [pros]
προσάραξη - [prosaraksi]
προσέγγιση - [prosegisi]
προσαρμόσιμο είδος - [prosarmosimo idos]
προσγειώνω - [prosgiono]
προσηλωμένος - [prosilomenos]
προσθήκη - [prosziki]
προσθετικό πολυμερές - [proszetiko polimeres]
προσκαλώ - [proskalo]
προσκρουστήρας - [proskrustiras]
προσκρούω - [proskruo]
προσομοίωση - [prosomiosi]
προσοχή - [prosoji]
προσπάθεια - [prospazia]
προσρόφηση - [prosrofisi]
προστάτης - [prostatis]
προστασία από χιονοστιβάδες - [prostasia apo jionostibades]
προστασία δεδομένων - [prostasia dedomenon]
προστασία του κλίματος - [prostasia tu klimatos]
προστασία του περιβάλλοντος - [prostasia tu peribalodos]
προστασία των ακτών - [prostasia ton akton]
προστασία των ειδών - [prostasia ton idon]
προστασία των ζώων - [prostasia ton soon]
προστασία των καταναλωτών - [prostasia ton katanaloton]
προστασία των πολιτών - [prostasia ton politon]
προστασία των υδάτων - [prostasia ton idaton]
προστατευτική αναπνευστική συσκευή - [prostateftiki anapnefstiki siskefi]
προστατευόμενη περιοχή - [prostatefomeni perioji]
προσφορά και ζήτηση - [prosfora ke sitisi]
προσχωματικό υλικό - [prosjomatiko iliko]
προσωδία - [prosodia]
προσωπικό - [prosopiko]
προσωπικότητα - [prosopikotita]
προσωρινό καταφύγιο - [prosorino katafigio]
προφήτης - [profitis]
προφίλ - [profil]
προφανώς - [profanos]
προφασίζομαι - [profasisome]
προφορά - [profora]
προφυλάξεις - [profilaksis]
προφυλακτικό - [profilaktiko]
προωθώ - [proozo]
προϊόν - [prion]
προϊόν διάσπασης - [prion diaspasis]
προϊόντα - [prioda]
προϋπολογισμός - [prupologismos]
προώθηση του εμπορίου και της βιομηχανίας - [proozisi tu eboriu ke tis biomijanias]
πρωί - [proi]
πρωινό - [proino]
πρωταθλήματα - [protazlimata]
πρωτακτίνιο - [protaktinio]
πρωταπριλιά - [protaprilia]
πρωτεΐνη - [proteΐni]
πρωτεύοντα - [protefoda]
πρωτοβάθμια εκπαίδευση - [protobazmia ekpedefsi]
πρωτοβουλία πολιτών - [protobulia politon]
πρωτογενές δάσος - [protogenes dasos]
πρωτογενής τομέας - [protogenis tomeas]
πρωτοκολλώ - [protokolo]
πρωτοπορία - [protoporia]
πρωτόζωα - [protosoa]
πρωτόκολλο - [protokolo]
πρωτόνιο - [protonio]
πρόβατο - [probato]
πρόβλεψη - [problepsi]
πρόβλεψη εκπομπής - [problepsi ekpobis]
πρόβλημα - [problima]
πρόγνωση - [prognosi]
πρόγνωση καιρού - [prognosi keru]
πρόγραμμα - [programa]
πρόγραμμα αυτοβοήθειας - [programa aftoboizias]
πρόγραμμα διατήρησης της φύσης - [programa diatirisis tis fisis]
πρόγραμμα σπουδών - [programa spudon]
πρόεδρος - [proedros]
πρόκληση - [proklisi]
πρόληψη κινδύνου - [prolipsi kindinu]
πρόληψη της ρύπανσης των υδάτων - [prolipsi tis ripansis ton idaton]
πρόσβαση στην θάλασσα - [prosbasi stin zalasa]
πρόσβαση στην πληροφόρηση - [prosbasi stin pliroforisi]
πρόσθεση - [proszesi]
πρόσθετο - [proszeto]
πρόσθετο καυσίμου - [proszeto kafsimu]
πρόσληψη θορύβου - [proslipsi zoribu]
πρόσληψη νερού - [proslipsi neru]
πρόστιμο - [prostimo]
πρόσφατος - [prosfatos]
πρόσφυγας - [prosfigas]
πρόσχωση - [prosjosi]
πρόσωπο - [prosopo]
πρότυπο - [protipo]
πρότυπο iso - [protipo iso]
πρότυπο συμπεριφοράς - [protipo siberiforas]
πρότυπο σχέδιο - [protipo sjedio]
πρώτες ύλες - [protes iles]
πρώτη ύλη - [proti ili]
πρώτο - [proto]
πρώτος - [protos]
πρώτος αριθμός - [protos arizmos]
πτήση - [ptisi]
πτεριδόφυτα - [pteridofita]
πτερυγιόποδα - [pterigiopoda]
πτηνοτροφία - [ptinotrofia]
πτητική οργανική ένωση - [ptitiki organiki enosi]
πτητική ουσία - [ptitiki usia]
πτητικότητα - [ptitikotita]
πτώση τάσης - [ptosi tasis]
πυγμάχος - [pigmajos]
πυγμαχία - [pigmajia]
πυγολαμπίδα - [pigolabida]
πυθμένας υδάτινου συστήματος - [pizmenas idatinu sistimatos]
πυκνοδομημένη περιοχή - [piknodomimeni perioji]
πυκνότητα - [piknotita]
πυκνότητα πληθυσμού - [piknotita plizismu]
πυξίδα - [piksida]
πυρά - [pira]
πυρίμαχο τούβλο - [pirimajo tublo]
πυρίτιο - [piritio]
πυραλένιο - [piralenio]
πυρασφάλεια - [pirasfalia]
πυρετός - [piretos]
πυρηνική έκρηξη - [piriniki ekriksi]
πυρηνική αντίδραση - [piriniki adidrasi]
πυρηνική ασφάλεια - [piriniki asfalia]
πυρηνική δοκιμή - [piriniki dokimi]
πυρηνική εγκατάσταση - [piriniki egkatastasi]
πυρηνική ενέργεια - [piriniki energia]
πυρηνική σχάση - [piriniki sjasi]
πυρηνική σύντηξη - [piriniki sidiksi]
πυρηνική φυσική - [piriniki fisiki]
πυρηνικό ατύχημα - [piriniko atijima]
πυρηνικό καύσιμο - [piriniko kafsimo]
πυρηνικό όπλο - [piriniko oplo]
πυρηνικός αντιδραστήρας - [pirinikos adidrastiras]
πυρηνικός κίνδυνος - [pirinikos kindinos]
πυρηνικός σταθμός - [pirinikos stazmos]
πυρκαγιά - [pirkagia]
πυροδότηση - [pirodotisi]
πυρομανής - [piromanis]
πυροπροστασία - [piroprostasia]
πυροσβέστης - [pirosbestis]
πυροσβεστική υπηρεσία - [pirosbestiki ipiresia]
πυροτέχνημα - [pirotejnima]
πυρόλυση - [pirolisi]
πόδι - [podi]
πόθος - [pozos]
πόκερ - [poker]
πόλεμος - [polemos]
πόλη - [poli]
πόλντερ - [polder]
πόνος - [ponos]
πόνος αυτί - [ponos afti]
πόροι - [pori]
πόρος - [poros]
πόρπη - [porpi]
πόρτα - [porta]
πόσιμο νερό - [posimo nero]
πόσιμος - [posimos]
πότε-πότε - [pote-pote]
πύκνωση - [piknosi]
πύκνωση της καθίζησης - [piknosi tis kazisisis]
πύον - [pion]
πύργος ψύξης - [pirgos psiksis]
πώμα - [poma]
πώμα φιάλης - [poma fialis]
πώς είσαι; - [pos ise;]
ράδιο - [radio]
ράμμα - [rama]
ράστερ - [raster]
ρέβα - [reba]
ρέοντα ύδατα - [reoda idata]
ρήγμα - [rigma]
ρήμα - [rima]
ρήνιο - [rinio]
ρίζα - [risa]
ρίζωμα - [risoma]
ραββίνος - [rabbinos]
ραδερφόρντιο - [raderfordio]
ραδιενέργεια - [radienergia]
ραδιενεργά απόβλητα - [radienerga apoblita]
ραδιενεργό στοιχείο - [radienergo stijio]
ραδιενεργός - [radienergos]
ραδιενεργός εκπομπή - [radienergos ekpobi]
ραδιενεργός μόλυνση - [radienergos molinsi]
ραδιενεργός ουσία - [radienergos usia]
ραδιοηλεκτρολογία - [radioilektrologia]
ραδιονουκλεΐδιο - [radionukleΐdio]
ραδιοστοιχείο - [radiostijio]
ραδιοφωνικό πρόγραμμα - [radiofoniko programa]
ραδιοϊσότοπο - [radiisotopo]
ραδιόφωνο - [radiofono]
ραδόνιο - [radonio]
ρακούν - [rakun]
ραντάρ - [radar]
ραπάνι - [rapani]
ρατσισμός - [ratsismos]
ρατσιστικός - [ratsistikos]
ραφινάρισμα - [rafinarisma]
ραχοκοκαλιά - [rajokokalia]
ρεζέρβα - [reserba]
ρεικότοπος - [rikotopos]
ρελιάζω - [reliaso]
ρευστοποίηση - [refstopiisi]
ρευστό - [refsto]
ρηγμάτωση - [rigmatosi]
ρητίνη - [ritini]
ρηχός - [rijos]
ριγώ - [rigo]
ρινίζω - [riniso]
ρινικές κοιλότητες - [rinikes kilotites]
ρινόκερος - [rinokeros]
ροδάκινο - [rodakino]
ροδίζω - [rodiso]
ροδιο - [rodio]
ροζ - [ros]
ροζάριο - [rosario]
ροκ - [rok]
ρολόι - [roli]
ρολόι χεριού - [roli jeriu]
ρομβος - [rombos]
ρουβίδιο - [rubidio]
ρουθηνιο - [ruzinio]
ρουθούνι - [ruzuni]
ρουμανικά - [rumanika]
ρουμπίνι - [rubini]
ρουφάω - [rufao]
ρουχισμός - [rujismos]
ρούβλι - [rubli]
ρούμι - [rumi]
ρυάκι - [riaki]
ρυζόγαλο - [risogalo]
ρυθμός - [rizmos]
ρυμουλκό - [rimulko]
ρυμουλκό πλοίο - [rimulko plio]
ρυπαντικό φορτίο - [ripadiko fortio]
ρωγμή - [rogmi]
ρωσικά - [rosika]
ρωσικός - [rosikos]
ρόδα - [roda]
ρόδι - [rodi]
ρόκα - [roka]
ρόφηση - [rofisi]
ρύζι - [risi]
ρύθμιση - [rizmisi]
ρύθμιση εναερίου κυκλοφορίας - [rizmisi enaeriu kikloforias]
ρύπανση - [ripansi]
ρύπανση από υδρογονάνθρακες - [ripansi apo idrogonanzrakes]
ρύπανση του περιβάλλοντος - [ripansi tu peribalodos]
ρύπανση των υδάτων - [ripansi ton idaton]
ρύποι - [ripi]
ρύπος εδάφους - [ripos edafus]
ρύπος των υδάτων - [ripos ton idaton]
ρώγα - [roga]
σάλιο - [salio]
σάνδαλο - [sandalo]
σάουνα - [sauna]
σέλινο - [selino]
σήμερα - [simera]
σήραγγα - [siraga]
σίδερο - [sidero]
σίδηρος - [sidiros]
σίελος - [sielos]
σίκαλη - [sikali]
σίρκο - [sirko]
σαγόνι - [sagoni]
σαζάνι - [sasani]
σακάκι - [sakaki]
σακίδιο - [sakidio]
σαλάτα - [salata]
σαλάχι - [salaji]
σαλαμάνδρα - [salamandra]
σαλμονέλες - [salmoneles]
σαμάριο - [samario]
σαμπάνια - [sabania]
σαμπουάν - [sabuan]
σανδάλι - [sandali]
σαξόφωνο - [saksofono]
σαπίζω - [sapiso]
σαπουνόπερα - [sapunopera]
σαπούνι - [sapuni]
σαπρόβιο - [saprobio]
σαπρόφυτο - [saprofito]
σαράντα - [sarada]
σαράντα έν - [sarada en]
σαράντα έξ - [sarada eks]
σαράντα δύο - [sarada dio]
σαράντα εννέα - [sarada enea]
σαράντα επτά - [sarada epta]
σαράντα οκτώ - [sarada okto]
σαράντα πέντε - [sarada pede]
σαράντα τέσσαρες - [sarada tesares]
σαράντα τρείς - [sarada tris]
σαρδέλα - [sardela]
σαρκοφάγα - [sarkofaga]
σαρκοφάγο - [sarkofago]
σαρώνω - [sarono]
σαυροειδή - [safroidi]
σαχάρα - [sajara]
σαύρα - [safra]
σβάστικα - [sbastika]
σβέρκος - [sberkos]
σβήνω - [sbino]
σγουρός - [sguros]
σεβασμός - [sebasmos]
σεζόν - [seson]
σειρά - [sira]
σεις - [sis]
σεισμικότητα - [sismikotita]
σεισμός - [sismos]
σελήνιο - [selinio]
σελίδα - [selida]
σενάριο - [senario]
σερβιτόρα - [serbitora]
σερβιτόρος - [serbitoros]
σεσουάρ - [sesuar]
σηκώνω - [sikono]
σημάδι - [simadi]
σημαία ευκαιρίας - [simea efkerias]
σημαδούρα - [simadura]
σημαντήρας - [simadiras]
σηματοδότης - [simatodotis]
σημείο - [simio]
σημείο βρασμού - [simio brasmu]
σημειακή πηγή - [simiaki pigi]
σημειωτής - [simiotis]
σημειωτική - [simiotiki]
σηπτική τάφρος - [siptiki tafros]
σιγαστήρας - [sigastiras]
σιγουριά - [siguria]
σιδεράς - [sideras]
σιδερένιος - [siderenios]
σιδερώνω - [siderono]
σιδηροδρομικές μεταφορές - [sidirodromikes metafores]
σιδηροδρομική άμαξα - [sidirodromiki amaksa]
σιδηροδρομική κυκλοφορία - [sidirodromiki kikloforia]
σιδηροδρομικό δίκτυο - [sidirodromiko diktio]
σιδηροδρομικός σταθμός - [sidirodromikos stazmos]
σιδηροτροχιά υψηλής ταχύτητας - [sidirotrojia ipsilis tajititas]
σιδηρουργός - [sidirurgos]
σιδηρούς - [sidirus]
σιδηρόδρομος - [sidirodromos]
σιλό - [silo]
σιμπόργκιο - [siborgkio]
σινεμά - [sinema]
σιρός - [siros]
σιτάρι - [sitari]
σιωνισμός - [sionismos]
σκάκι - [skaki]
σκάλα - [skala]
σκάφος - [skafos]
σκέφτομαι - [skeftome]
σκήπτρο - [skiptro]
σκακιέρα - [skakiera]
σκανdιο - [skandio]
σκαρφάλωμα - [skarfaloma]
σκατζόχοιρος - [skatsojiros]
σκελετός - [skeletos]
σκεπτικό - [skeptiko]
σκηνοθέτης - [skinozetis]
σκι - [ski]
σκιά - [skia]
σκληρός - [skliros]
σκληρός δίσκος - [skliros diskos]
σκληρός χιτώνας - [skliros jitonas]
σκληρότητα - [sklirotita]
σκληρότητα του ύδατος - [sklirotita tu idatos]
σκοινί - [skini]
σκοπευτήριο - [skopeftirio]
σκορπιός - [skorpios]
σκοτώνω - [skotono]
σκουλήκι - [skuliki]
σκουλαρίκι - [skulariki]
σκουπίζω - [skupiso]
σκουραίνω - [skureno]
σκουριά - [skuria]
σκουριασμένος - [skuriasmenos]
σκούπα - [skupa]
σκούτερ - [skuter]
σκυρωρυχείο - [skirorijio]
σκυρόδεμα - [skirodema]
σκωληκοειδής απόφυση - [skolikoidis apofisi]
σκωληκοειδεκτομή - [skolikoidektomi]
σκωρία - [skoria]
σκόνη - [skoni]
σκόρδο - [skordo]
σκύλος - [skilos]
σλοβενικά - [slobenika]
σλοβενικός - [slobenikos]
σμίλη - [smili]
σοκολάτα - [sokolata]
σοσιαλισμός - [sosialismos]
σοσιαλιστής - [sosialistis]
σουίτα - [suita]
σουβέρ - [suber]
σουηδικά - [suidika]
σουντόκου - [sudoku]
σουτιέν - [sutien]
σοφίτα - [sofita]
σούπα - [supa]
σπέρμα - [sperma]
σπήλαιο - [spileo]
σπίρτο - [spirto]
σπίτι - [spiti]
σπανάκι - [spanaki]
σπείρειν - [spirin]
σπειρί του κακάο - [spiri tu kakao]
σπιτονοικοκύρης - [spitonikokiris]
σποδός - [spodos]
σπονδυλική στήλη - [spondiliki stili]
σπονδυλωτά - [spondilota]
σποροαπολύμανση - [sporoapolimansi]
σπουδαστής - [spudastis]
σπουργίτης - [spurgitis]
σπυρί - [spiri]
σπόνδυλος - [spondilos]
σπόριο - [sporio]
σπόρος - [sporos]
στάδιο - [stadio]
στάθμη της θάλασσας - [stazmi tis zalasas]
στάση - [stasi]
στάχτη - [stajti]
στέγαση - [stegasi]
στέγαση σταβλισμός των ζώων - [stegasi stablismos ton soon]
στέγαση των ζώων - [stegasi ton soon]
στέγαση χαμηλού κόστους - [stegasi jamilu kostus]
στέγη - [stegi]
στέγνωμα - [stegnoma]
στέκομαι - [stekome]
στέλνω φαξ - [stelno faks]
στέρνο - [sterno]
στήθος - [stizos]
στήλη - [stili]
στίζω - [stiso]
στίχοι - [stiji]
σταδιακή αύξηση - [stadiaki afksisi]
σταθεροποίηση αμμοθίνας - [stazeropiisi amozinas]
σταθεροποίηση του εδάφους - [stazeropiisi tu edafus]
σταθερός - [stazeros]
σταθμός - [stazmos]
σταθμός ηλιακής ενέργειας - [stazmos iliakis energias]
σταθμός λεωφορείων - [stazmos leoforion]
σταθμός παραγωγής ηλεκτρικής ενέργειας - [stazmos paragogis ilektrikis energias]
σταθμός πλήρωσης - [stazmos plirosis]
σταθμός συνδυασμένης παραγωγής ενέργειας - [stazmos sindiasmenis paragogis energias]
στατιστική - [statistiki]
στατιστική ανάλυση - [statistiki analisi]
σταυροδρόμι - [stafrodromi]
σταυρόλεξο - [stafrolekso]
σταυρώνω - [stafrono]
σταφίδα - [stafida]
σταφύλι - [stafili]
σταχτοδοχείο - [stajtodojio]
σταύρωση - [stafrosi]
στείρωση - [stirosi]
στεγαστικό πρόγραμμα - [stegastiko programa]
στεγνό καθάρισμα - [stegno kazarisma]
στεγνός - [stegnos]
στενά - [stena]
στενός - [stenos]
στερεά κατάσταση - [sterea katastasi]
στερεό σωματίδιο - [stereo somatidio]
στερλίνα - [sterlina]
στεροειδές - [steroides]
στιβάδα αναστροφής - [stibada anastrofis]
στιβάδα του όζοντος - [stibada tu osodos]
στιγμή - [stigmi]
στιλπνότητα - [stilpnotita]
στοά - [stoa]
στοίβα - [stiba]
στοιχεία - [stijia]
στοιχείο - [stijio]
στοιχείο πυρηνικού καυσίμου - [stijio piriniku kafsimu]
στοιχείο στεγανοποίησης - [stijio steganopiisis]
στοιχειώδης παρακολούθηση - [stijiodis parakoluzisi]
στολή - [stoli]
στομάχι - [stomaji]
στράγγιση - [stragisi]
στραγγαλιστή - [stragalisti]
στρατηγικός - [stratigikos]
στρατηγός - [stratigos]
στρατιωτική περιοχή - [stratiotiki perioji]
στρατιωτική περιοχή εκτός ενεργείας - [stratiotiki perioji ektos energias]
στρατιωτικό υλικό - [stratiotiko iliko]
στρατιώτης - [stratiotis]
στρατοκρατία - [stratokratia]
στρατόπεδο - [stratopedo]
στρατός - [stratos]
στρατόσφαιρα - [stratosfera]
στρείδι - [stridi]
στριφώνω - [strifono]
στρουθοκάμηλος - [struzokamilos]
στρόβιλος - [strobilos]
στρόντιο - [strodio]
στρώμα - [stroma]
στυλό - [stilo]
στυλό διαρκείας - [stilo diarkias]
στόμα - [stoma]
στύλος - [stilos]
συ - [si]
συγγενείς και φίλοι - [sigenis ke fili]
συγγνώμη - [signomi]
συγγραφικά δικαιώματα - [sigrafika dikeomata]
συγκέντρωση - [sigkedrosi]
συγκέντρωση θείου - [sigkedrosi ziu]
συγκέντρωση οικισμών - [sigkedrosi ikismon]
συγκαλώ - [sigkalo]
συγκατάθεση - [sigkatazesi]
συγκατοίκηση - [sigkatikisi]
συγκεντρωτισμός - [sigkedrotismos]
συγκομιδή - [sigkomidi]
συγκράτηση - [sigkratisi]
συγκριτικό δίκαιο - [sigkritiko dikeo]
συγκρούομαι - [sigkruome]
συγκρότημα διαμερισμάτων - [sigkrotima diamerismaton]
συγκόλληση - [sigkolisi]
συγχρονίζω - [sigjroniso]
συγχώνευση - [sigjonefsi]
συζήτηση - [sisitisi]
συζήτηση για τα πυρηνικά - [sisitisi gia ta pirinika]
συζυγία - [sisigia]
συζυγικός - [sisigikos]
συζυγοκτονία - [sisigoktonia]
συζυγοκτόνος - [sisigoktonos]
συκώτι - [sikoti]
συλλέκτης αερίου - [silektis aeriu]
συλλαμβάνω - [silambano]
συλλεκτήρας - [silektiras]
συμβίωση - [simbiosi]
συμβατική ενέργεια - [simbatiki energia]
συμβουλή - [simbuli]
συμβόλαιο - [simboleo]
συμμαθητής - [simazitis]
συμμετοχή - [simetoji]
συμμετοχή του δημοσίου - [simetoji tu dimosiu]
συμμετρικός κήπος γαλλικού τύπου - [simetrikos kipos galiku tipu]
συμπάθεια - [sibazia]
συμπέθερος - [sibezeros]
συμπίεση - [sibiesi]
συμπαθητικό νευρικό σύστημα - [sibazitiko nefriko sistima]
συμπεθέρα - [sibezera]
συμπεραίνω - [sibereno]
συμπεριφορά - [siberifora]
συμπεριφορά ομάδας - [siberifora omadas]
συμπεριφορά του καταναλωτή - [siberifora tu katanaloti]
συμπεριφορά των ζώων - [siberifora ton soon]
συμπιεστής - [sibiestis]
συμπύκνωση - [sibiknosi]
συμπύκνωση του εδάφους - [sibiknosi tu edafus]
συμφέρον - [simferon]
συμφωνία - [simfonia]
συμφωνητικό - [simfonitiko]
συμφωνώ - [simfono]
συνάδελφος - [sinadelfos]
συνάντηση - [sinadisi]
συνέδριο - [sinedrio]
συνέπειες - [sinepies]
συνήθεια - [sinizia]
συναίσθηση - [sineszisi]
συναγερμός - [sinagermos]
συναγωγή - [sinagogi]
συναδελφικότητα - [sinadelfikotita]
συναινετικός - [sinenetikos]
συνδετήρας - [sindetiras]
συνδικαλιστική οργάνωση - [sindikalistiki organosi]
συνδυασμένες μεταφορές - [sindiasmenes metafores]
συνειδησιολογία - [sinidisiologia]
συνεργία - [sinergia]
συνεργασία - [sinergasia]
συνεργασία για την ανάπτυξη - [sinergasia gia tin anaptiksi]
συνεργισμός - [sinergismos]
συνεχής - [sinejis]
συνηθισμένος - [sinizismenos]
συνθήκες εργασίας - [sinzikes ergasias]
συνθήκη - [sinziki]
συνθετική υφαντική ίνα - [sinzetiki ifadiki ina]
συνθετικό απορρυπαντικό - [sinzetiko aporipadiko]
συνθετικό υλικό - [sinzetiko iliko]
συνοικολογία - [sinikologia]
συνοφειλέτης - [sinofiletis]
συντάκτης - [sidaktis]
συντήρηση - [sidirisi]
συντήρηση τροφίμων - [sidirisi trofimon]
συνταγή - [sidagi]
συνταγματικά - [sidagmatika]
συνταγματικό δίκαιο - [sidagmatiko dikeo]
συνταξιούχος - [sidaksiujos]
συντελεστής βιοσυγκέντρωσης - [sidelestis biosigkedrosis]
συντομέυω - [sidomefo]
συντομεύω - [sidomefo]
συντομογραφία - [sidomografia]
συντονισμός - [sidonismos]
συντρέχω - [sidrejo]
συντροφικότητα - [sidrofikotita]
συνωστισμός - [sinostismos]
συρμός - [sirmos]
συρραπτικό - [siraptiko]
συρτάρι - [sirtari]
συσκευή dvd - [siskefi dvd]
συσκευή πολυφασματικής σάρωσης - [siskefi polifasmatikis sarosis]
συσκευασία - [siskefasia]
συσσωρευτής - [sisoreftis]
συσσωρευτικός - [sisoreftikos]
συσσώρευση ρύπων - [sisorefsi ripon]
συστημική θεωρία - [sistimiki zeoria]
συστοιχία - [sistijia]
συυή τηλεομοιοτυπίας - [siii tileomiotipias]
συχνός - [sijnos]
συχνότητα - [sijnotita]
σφάζω - [sfaso]
σφάλμα - [sfalma]
σφήκα - [sfika]
σφίγγα - [sfiga]
σφαγή ζώων - [sfagi soon]
σφαγείο - [sfagio]
σφαιρικός αστρολάβος - [sferikos astrolabos]
σφιγκτήρας - [sfigktiras]
σφοδρός - [sfodros]
σφουγγάρι - [sfugari]
σφουγγαρίστρα - [sfugaristra]
σφραγιδόλιθος - [sfragidolizos]
σφυρί - [sfiri]
σφυρίχτρα - [sfirijtra]
σχέδιο - [sjedio]
σχέδιο ανάπτυξης - [sjedio anaptiksis]
σχέδιο εξυγίανσης - [sjedio eksigiansis]
σχέδιο νόμου - [sjedio nomu]
σχέση ανθρώπου-φύσης - [sjesi anzropu-fisis]
σχέση δομής-δραστηριότητας - [sjesi domis-drastiriotitas]
σχέση δόσης-ανταπόκρισης - [sjesi dosis-adapokrisis]
σχίσμα - [sjisma]
σχεδιάζω - [sjediaso]
σχεδιασμός - [sjediasmos]
σχεδιασμός κυκλοφορίας - [sjediasmos kikloforias]
σχεδιαστής - [sjediastis]
σχεδόν - [sjedon]
σχεσιακή βάση δεδομένων - [sjesiaki basi dedomenon]
σχιζοφρένεια - [sjisofrenia]
σχιστοσωμίαση - [sjistosomiasi]
σχολείο - [sjolio]
σχολική διδασκαλία - [sjoliki didaskalia]
σχολική εργασία - [sjoliki ergasia]
σχολικό πρόγραμμα - [sjoliko programa]
σωληνώσεις - [solinosis]
σωματέμπορος - [somateboros]
σωματίδιο - [somatidio]
σωρός - [soros]
σόδα - [soda]
σύγκριση - [sigkrisi]
σύγκρουση - [sigkrusi]
σύγκρουση συμφερόντων - [sigkrusi simferodon]
σύζυγος - [sisigos]
σύμβαση - [simbasi]
σύμπραξη - [sibraksi]
σύμπτυξη - [sibtiksi]
σύνδεσμοι - [sindesmi]
σύνδρομο του άρρωστου κτηρίου - [sindromo tu arostu ktiriu]
σύνορο - [sinoro]
σύνταγμα - [sidagma]
σύνταξη - [sidaksi]
σύσπαση - [sispasi]
σύσταση εταιρείας - [sistasi eterias]
σύστημα έγκαιρης προειδοποίησης - [sistima egkeris proidopiisis]
σύστημα αμοιβών - [sistima amibon]
σύστημα ασφαλείας - [sistima asfalias]
σύστημα βιβλιογραφικών πληροφοριών - [sistima bibliografikon pliroforion]
σύστημα γεωγραφικών πληροφοριών - [sistima geografikon pliroforion]
σύστημα διάσωσης - [sistima diasosis]
σύστημα ενδοκρινών αδένων - [sistima endokrinon adenon]
σύστημα επεξεργασίας δεδομένων - [sistima epeksergasias dedomenon]
σύστημα καλλιέργειας - [sistima kaliergias]
σύστημα λογαριασμών - [sistima logariasmon]
σύστημα πληροφοριών παραπομπής - [sistima pliroforion parapobis]
σύστημα προειδοποίησης - [sistima proidopiisis]
σύστημα προστασίας - [sistima prostasias]
σύστημα στατιστικών πληροφοριών - [sistima statistikon pliroforion]
σύστημα συντεταγμένων - [sistima sidetagmenon]
σύστημα τεκμηρίωσης - [sistima tekmiriosis]
σύστημα υδροδότησης - [sistima idrodotisis]
σώμα - [soma]
σώμα του ανθρώπου - [soma tu anzropu]
σώρευση ρύπων - [sorefsi ripon]
τάγμα - [tagma]
τάξη - [taksi]
τάξος - [taksos]
τάπητας - [tapitas]
τάρανδος - [tarandos]
τάση - [tasi]
τάστο - [tasto]
τάφος - [tafos]
τάφρος - [tafros]
τέλμα - [telma]
τέλος - [telos]
τέλος καλό, όλα καλά - [telos kalo, ola kala]
τέμενος - [temenos]
τένις - [tenis]
τένοντας - [tenodas]
τέρβιο - [terbio]
τέσσερα - [tesera]
τέταρτο - [tetarto]
τέφρα - [tefra]
τέχνη - [tejni]
τήξη - [tiksi]
τήξη του πυρήνα - [tiksi tu pirina]
τίγρη - [tigri]
τίμιος - [timios]
τίποτα - [tipota]
τίτλος - [titlos]
ταινία - [tenia]
ταλάντωση - [taladosi]
ταλέντο - [taledo]
ταμείο παρέμβασης - [tamio parembasis]
ταμείο χρηματοδότησης - [tamio jrimatodotisis]
ταμιευτήρας - [tamieftiras]
ταμιλικά - [tamilika]
ταμπάκος - [tabakos]
ταμπού - [tabu]
τανίνη - [tanini]
ταντάλιο - [tadalio]
ταξί - [taksi]
ταξινόμηση εικόνας - [taksinomisi ikonas]
ταξιτζής - [taksitsis]
ταξονομία - [taksonomia]
ταπετσαρία - [tapetsaria]
ταραχή - [taraji]
τασιενεργός ουσία - [tasienergos usia]
ταταρικά - [tatarika]
ταφονομία - [tafonomia]
ταφόπλακα - [tafoplaka]
ταχίνι - [tajini]
ταχεία δοκιμασία - [tajia dokimasia]
ταχυδρομείο - [tajidromio]
ταχυδρόμος - [tajidromos]
ταχύτητα - [tajitita]
ταχύτητα διαφυγής - [tajitita diafigis]
ταϋλανδικά - [taflandika]
τείχος - [tijos]
τεκμηρίωση - [tekmiriosi]
τεκτονική - [tektoniki]
τελειοθηρία - [telioziria]
τελειομανία - [teliomania]
τελειώνω - [teliono]
τελεσίγραφο - [telesigrafo]
τελικός κυπέλλου - [telikos kipelu]
τελλούριο - [telurio]
τελουγκουικά - [telugkuika]
τελωνείο - [telonio]
τελωνειακές αρχές - [teloniakes arjes]
τεμαχιστής - [temajistis]
τεμπεσίρι - [tebesiri]
τερατογονία - [teratogonia]
τερμίτες - [termites]
τεταρτιάζω - [tetartiaso]
τετράγωνα - [tetragona]
τετράγωνο - [tetragono]
τετράγωνος - [tetragonos]
τετράδιο - [tetradio]
τετράποδος - [tetrapodos]
τετράχρονος κινητήρας - [tetrajronos kinitiras]
τετραγαμμάδιον - [tetragamadion]
τετραγωνική ρίζα - [tetragoniki risa]
τετραδιάστατος - [tetradiastatos]
τετρασκέλιον - [tetraskelion]
τετρατόμηση - [tetratomisi]
τεχνητή λίμνη - [tejniti limni]
τεχνητιο - [tejnitio]
τεχνική δειγματοληψίας - [tejniki digmatolipsias]
τεχνική διοίκησης - [tejniki diikisis]
τεχνική παρακολούθησης - [tejniki parakoluzisis]
τεχνική ψηφιακής επεξεργασίας εικόνας - [tejniki psifiakis epeksergasias ikonas]
τεχνικοί κανόνες - [tejniki kanones]
τεχνολογία - [tejnologia]
τεχνολογία ορυχείων - [tejnologia orijion]
τεχνολογία πλάσματος - [tejnologia plasmatos]
τεχνολογία πληροφοριών - [tejnologia pliroforion]
τεχνολογία πολυμέσων - [tejnologia polimeson]
τεχνολογία του άνθρακα - [tejnologia tu anzraka]
τεχνολογία τροφίμων - [tejnologia trofimon]
τεχνολογία υλικών - [tejnologia ilikon]
τζίτζικας - [tsitsikas]
τζαζ - [tsas]
τζετ - [tset]
τηλέφωνο - [tilefono]
τηλέφωνο ip - [tilefono ip]
τηλεανίχνευση - [tileanijnefsi]
τηλεθέρμανση - [tilezermansi]
τηλεματική - [tilematiki]
τηλεμετρία - [tilemetria]
τηλεομοιοτυπώ - [tileomiotipo]
τηλεοπτικό πρόγραμμα - [tileoptiko programa]
τηλεπικοινωνία - [tilepikinonia]
τηλεσκόπιο - [tileskopio]
τηλεσυνδιάσκεψη - [tilesindiaskepsi]
τηλεσυνδιασκέπτομαι - [tilesindiaskeptome]
τηλεφωνώ - [tilefono]
τηλεφώνημα - [tilefonima]
τηλεχειριστήριο - [tilejiristirio]
τηλεόραση - [tileorasi]
τιμάριθμος - [timarizmos]
τιμή - [timi]
τιμή ph - [timi ph]
τιμή άχρηστου υλικού - [timi ajristu iliku]
τιμολόγηση βάσει κόστους - [timologisi basi kostus]
τιρμπουσόν - [tirbuson]
τιτάνιο - [titanio]
τμήμα ελέγχου - [tmima elegju]
το - [to]
το συντομότερο δυνατόν - [to sidomotero dinaton]
τοίχος - [tijos]
τοίχωμα - [tijoma]
τοιχίο - [tijio]
τοιχείο - [tijio]
τοιχοποιία - [tijopiia]
τολμηρός - [tolmiros]
τομάτα - [tomata]
τομέας - [tomeas]
τομέας της αλιείας - [tomeas tis aliias]
τοξίνη - [toksini]
τοξικά απόβλητα - [toksika apoblita]
τοξική επίδραση - [toksiki epidrasi]
τοξικολογία - [toksikologia]
τοξικομανής - [toksikomanis]
τοξικό μέταλλο - [toksiko metalo]
τοξικότητα - [toksikotita]
τοξικότητα των φυτοφαρμάκων - [toksikotita ton fitofarmakon]
τοξότης - [toksotis]
τοπική αναψυχή - [topiki anapsiji]
τοπική αυτοδιοίκηση - [topiki aftodiikisi]
τοπική κυκλοφορία - [topiki kikloforia]
τοπική παροχή θέρμανσης - [topiki paroji zermansis]
τοποθέτηση παγίδων - [topozetisi pagidon]
τοποθεσία παγκόσμιας κληρονομιάς - [topozesia pagkosmias klironomias]
τοπολογία - [topologia]
τορπίλλη - [torpili]
τοστιέρα - [tostiera]
τουαλέτα - [tualeta]
τουλίπα - [tulipa]
τουρισμός - [turismos]
τουριστική περιοχή - [turistiki perioji]
τουρκικά - [turkika]
τούβλο - [tublo]
τούνδρα - [tundra]
τούρκικα - [turkika]
τούρτα - [turta]
τράγος - [tragos]
τράπεζα - [trapesa]
τράπεζα γονιδίων - [trapesa gonidion]
τράπεζα δεδομένων έντυπου υλικού - [trapesa dedomenon edipu iliku]
τράπεζα περιβαλλοντικών δειγμάτων - [trapesa peribalodikon digmaton]
τρένο - [treno]
τρέχω - [trejo]
τρία - [tria]
τρίαθλο - [triazlo]
τρίμηνο - [trimino]
τρίτιο - [tritio]
τρίτο - [trito]
τρίφτης - [triftis]
τρίχωμα - [trijoma]
τραβεστί - [trabesti]
τραβώ - [trabo]
τραγουδάω - [tragudao]
τραγουδιστής - [tragudistis]
τραγουδώ - [tragudo]
τραγούδι - [tragudi]
τραμ - [tram]
τραμπάλα - [trabala]
τραπέζι - [trapesi]
τραπεζάκι σαλονιού - [trapesaki saloniu]
τραπεζίτης - [trapesitis]
τραπεζαρία - [trapesaria]
τραπεζικό σύστημα - [trapesiko sistima]
τραπεζομάντηλο - [trapesomadilo]
τραχειόφυτα - [trajiofita]
τραύμα - [trafma]
τρεις χιλιάδες - [tris jiliades]
τριάντα - [triada]
τριάντα έν - [triada en]
τριάντα έξ - [triada eks]
τριάντα δύο - [triada dio]
τριάντα εννέα - [triada enea]
τριάντα επτά - [triada epta]
τριάντα οκτώ - [triada okto]
τριάντα πέντε - [triada pede]
τριάντα τέσσαρες - [triada tesares]
τριάντα τρείς - [triada tris]
τριαδική αρχή - [triadiki arji]
τριαζίνη - [triasini]
τριαλογονούχο παράγωγο του μεθανίου - [trialogonujo paragogo tu mezaniu]
τριανδρία - [triandria]
τριαντάφυλλο - [triadafilo]
τριγωνικός - [trigonikos]
τριγωνομετρία - [trigonometria]
τριλογία - [trilogia]
τρισδιάστατος - [trisdiastatos]
τριτοβάθμια εκπαίδευση - [tritobazmia ekpedefsi]
τριτογενής τομέας - [tritogenis tomeas]
τρομοκράτης - [tromokratis]
τρομοκρατία - [tromokratia]
τρομπέτα - [trobeta]
τροπικές ζώνες - [tropikes sones]
τροπικοί - [tropiki]
τροπικό δάσος - [tropiko dasos]
τροπικό δάσος βροχής - [tropiko dasos brojis]
τροπικό κλίμα - [tropiko klima]
τροπικό φυτό - [tropiko fito]
τροπικός - [tropikos]
τροποποίηση νόμου - [tropopiisi nomu]
τροποσφαιρικό όζον - [troposferiko oson]
τροπόσφαιρα - [troposfera]
τροφή - [trofi]
τροφική αλυσίδα - [trofiki alisida]
τροφική οικολογία - [trofiki ikologia]
τροφική παραγωγή - [trofiki paragogi]
τροφικό επίπεδο - [trofiko epipedo]
τροφοδοσία πυράς - [trofodosia piras]
τροχαίο ατύχημα - [trojeo atijima]
τροχιά - [trojia]
τροχός - [trojos]
τροχόσπιτο - [trojospito]
τρούλος - [trulos]
τρυπημένος - [tripimenos]
τρωκτικό - [troktiko]
τρόλεϊ - [troli]
τρόμος - [tromos]
τρόπος ζωής - [tropos sois]
τρόφιμα - [trofima]
τρόχισμα - [trojisma]
τρώγω - [trogo]
τρώω - [troo]
τσάι - [tse]
τσάπα - [tsapa]
τσάρος - [tsaros]
τσέλο - [tselo]
τσέπη - [tsepi]
τσίρκο - [tsirko]
τσίτα - [tsita]
τσίχλα - [tsijla]
τσαγιέρα - [tsagiera]
τσακώνομαι - [tsakonome]
τσαντάκης - [tsadakis]
τσεχικά - [tsejika]
τσιγάρο - [tsigaro]
τσιγαρίζω - [tsigariso]
τσιγαριλίκι - [tsigariliki]
τσικνιάς - [tsiknias]
τσιμέντο - [tsimedo]
τσιτάχ - [tsitaj]
τσουνάμι - [tsunami]
τσούχτρα - [tsujtra]
τυπογράφος - [tipografos]
τυπογραφείο - [tipografio]
τυποποίηση - [tipopiisi]
τυρκουάζ - [tirkuas]
τυρφώνας - [tirfonas]
τυφλό σημείο - [tiflo simio]
τυφλός - [tiflos]
τυφώνας - [tifonas]
τόκος - [tokos]
τόξο - [tokso]
τόπος - [topos]
τόπος αμμοληψίας - [topos amolipsias]
τύμπανο - [tibano]
τύπος - [tipos]
τύπος εδάφους - [tipos edafus]
τύπος κλίματος - [tipos klimatos]
τύραννος - [tiranos]
τύρφη - [tirfi]
τύφλωση - [tiflosi]
τώρα - [tora]
υαλοβάμβακας - [ialobambakas]
υαλοπίνακας - [ialopinakas]
υαλοποίηση - [ialopiisi]
υαλουργία - [ialurgia]
υαλόπαγος - [ialopagos]
υβριδοποίηση - [ibridopiisi]
υγεία - [igia]
υγεία του ανθρώπου - [igia tu anzropu]
υγειονομική εγκατάσταση - [igionomiki egkatastasi]
υγειονομική περίθαλψη - [igionomiki perizalpsi]
υγειονομικός κανονισμός - [igionomikos kanonismos]
υγιεινή - [igiini]
υγιεινή των τροφίμων - [igiini ton trofimon]
υγρή κατάσταση - [igri katastasi]
υγρασία - [igrasia]
υγρασία εδάφους - [igrasia edafus]
υγροποίηση αερίου - [igropiisi aeriu]
υγροποίηση του άνθρακα - [igropiisi tu anzraka]
υγροποιημένο αέριο - [igropiimeno aerio]
υγροσκοπικός - [igroskopikos]
υγρό - [igro]
υγρός - [igros]
υγρότοπος - [igrotopos]
υδάτινη οδός - [idatini odos]
υδατάνθρακας - [idatanzrakas]
υδαταγωγός - [idatagogos]
υδατική διάβρωση - [idatiki diabrosi]
υδατοκαλλιέργεια - [idatokaliergia]
υδατομετρία - [idatometria]
υδατοστεγής - [idatostegis]
υδατοσφαίριση - [idatosferisi]
υδατοφράκτης - [idatofraktis]
υδατόπτωση - [idatoptosi]
υδατόρρευμα - [idatorefma]
υδράργυρος - [idrargiros]
υδραγωγείο - [idragogio]
υδραυλική - [idrafliki]
υδροβιολογία - [idrobiologia]
υδρογεωλογία - [idrogeologia]
υδρογονάνθρακας - [idrogonanzrakas]
υδρογραφία - [idrografia]
υδρογόνο - [idrogono]
υδροδότηση - [idrodotisi]
υδροηλεκτρική ενέργεια - [idroilektriki energia]
υδρολογία - [idrologia]
υδρολογική ροή - [idrologiki roi]
υδρολογικός κύκλος - [idrologikos kiklos]
υδρομετεωρολογία - [idrometeorologia]
υδροπεπόνι - [idropeponi]
υδροφράκτης - [idrofraktis]
υδροφόρος - [idroforos]
υδροφόρος ορίχοντας - [idroforos orijodas]
υδροχλωρικό οξύ - [idrojloriko oksi]
υδροϋάκυνθος - [idruakinzos]
υδρόβιο ζώο - [idrobio soo]
υδρόβιο θηλαστικό - [idrobio zilastiko]
υδρόβιο φυτό - [idrobio fito]
υδρόβιος μικρο-οραγανισμος - [idrobios mikro-oraganismos]
υδρόβιος οργανισμός - [idrobios organismos]
υδρόθειο - [idrozio]
υδρόλυση - [idrolisi]
υδρόμυλος - [idromilos]
υδρόσφαιρα - [idrosfera]
υλικά - [ilika]
υλικά οικοδομών - [ilika ikodomon]
υλοτομία - [ilotomia]
υμένας - [imenas]
υμένιο - [imenio]
υμενόπτερα - [imenoptera]
υπάγω - [ipago]
υπάλληλος - [ipalilos]
υπέδαφος - [ipedafos]
υπέρηχος - [iperijos]
υπέρθυρο - [iperziro]
υπέρταση - [ipertasi]
υπέρυθρη ακτινοβολία - [iperizri aktinobolia]
υπέρυθρος - [iperizros]
υπαίθρια εξόρυξη - [ipezria eksoriksi]
υπαίθριο καταφύγιο - [ipezrio katafigio]
υπακτικό - [ipaktiko]
υπεράσπιση - [iperaspisi]
υπερένταση - [iperedasi]
υπεραγορά - [iperagora]
υπεραλίευση - [iperaliefsi]
υπερασπιστής - [iperaspistis]
υπερβολή - [iperboli]
υπερβόσκηση - [iperboskisi]
υπερδιήθηση - [iperdiizisi]
υπερεκμετάλλευση - [iperekmetalefsi]
υπεριώδης ακτινοβολία - [iperiodis aktinobolia]
υπερκείμενο - [iperkimeno]
υπερλίπανση - [iperlipansi]
υπερπληθυσμός - [iperplizismos]
υπερπόντια αλιεία - [iperpodia aliia]
υπερτροφισμός - [ipertrofismos]
υπερφόρτωση - [iperfortosi]
υπερχλωροαιθυλένιο - [iperjloroezilenio]
υπερωρία - [iperoria]
υπερύψωση - [iperipsosi]
υπηρεσία βιβλιοθήκης - [ipiresia bibliozikis]
υπηρεσία διάσωσης - [ipiresia diasosis]
υπηρεσία επί γραμμής - [ipiresia epi gramis]
υπηρεσία πληροφοριών - [ipiresia pliroforion]
υπνοδωμάτιο - [ipnodomatio]
υπνοθάλαμος - [ipnozalamos]
υπνωτήριο - [ipnotirio]
υποβάθμιση του περιβάλλοντος - [ipobazmisi tu peribalodos]
υποβάλλω - [ipobalo]
υποβαθμίζω - [ipobazmiso]
υποβρύχια μορφολογία - [ipobrijia morfologia]
υποβρύχιο - [ipobrijio]
υποβρύχιος - [ipobrijios]
υπογράφω - [ipografo]
υπογραμμίζω - [ipogramiso]
υπογραφή - [ipografi]
υποδομή - [ipodomi]
υποδοχή - [ipodoji]
υποθερμία - [ipozermia]
υποκαπνισμός - [ipokapnismos]
υποκατάστατο φωσφορικών αλάτων - [ipokatastato fosforikon alaton]
υπολείμματα - [ipolimata]
υπολείμματα βυθοκόρησης - [ipolimata bizokorisis]
υπολείμματα κατεργασίας ξύλου - [ipolimata katergasias ksilu]
υπολειμματικό υγρό αλκοολικής ζύμωσης - [ipolimatiko igro alkoolikis simosis]
υπολειπόμενος κίνδυνος - [ipolipomenos kindinos]
υπολογισμός - [ipologismos]
υπολογιστής - [ipologistis]
υπολογιστής των αντικυθήρων - [ipologistis ton adikiziron]
υπομονετικός - [ipomonetikos]
υποπροϊόν - [ipoprion]
υποτροπή - [ipotropi]
υποτροπικός - [ipotropikos]
υπουργικό συμβούλιο - [ipurgiko simbulio]
υποχρέωση επισήμανσης - [ipojreosi episimansis]
υπόγεια διάθεση - [ipogia diazesi]
υπόγειο - [ipogio]
υπόγειο λατομείο - [ipogio latomio]
υπόγειο νερό - [ipogio nero]
υπόγειος - [ipogios]
υπόγειος σιδηρόδρομος - [ipogios sidirodromos]
υπόδειγμα - [ipodigma]
υπόηχος - [ipoijos]
υπόθεμα - [ipozema]
υπόθεση - [ipozesi]
υπόστεγο - [ipostego]
υπόταση - [ipotasi]
υττερβίο - [iterbio]
υττριο - [itrio]
υφάλμυρα ύδατα - [ifalmira idata]
υψηλό όρος - [ipsilo oros]
υψικάμινος - [ipsikaminos]
υψόμετρο - [ipsometro]
φάκελος - [fakelos]
φάλαινα - [falena]
φάρμακο - [farmako]
φάρος - [faros]
φάρυγγας - [farigas]
φάτνωμα - [fatnoma]
φέρουσα ικανότητα - [ferusa ikanotita]
φίλτρο - [filtro]
φαγούρα - [fagura]
φαινόλη - [fenoli]
φαινόμενο του θερμοκηπίου - [fenomeno tu zermokipiu]
φακή - [faki]
φακός - [fakos]
φαλαινοθηρία - [falenoziria]
φανατικός - [fanatikos]
φανατισμός - [fanatismos]
φανερόγαμα - [fanerogama]
φανζίν - [fansin]
φανός - [fanos]
φαξ - [faks]
φαράγγι - [faragi]
φαράντ - [farad]
φαρμακείο - [farmakio]
φαρμακευτική βιομηχανία - [farmakeftiki biomijania]
φαρμακευτικό φυτό - [farmakeftiko fito]
φαρμακοκινητική - [farmakokinitiki]
φαρμακολογία - [farmakologia]
φαρμακοποιός - [farmakopios]
φασιανόs - [fasianos]
φασκωλόμυς - [faskolomis]
φασματική ζώνη - [fasmatiki soni]
φασματοσκοπία - [fasmatoskopia]
φασματοσκοπία υπερύθρου - [fasmatoskopia iperizru]
φαστφουντά - [fastfuda]
φατνίο - [fatnio]
φαύλος κύκλος - [faflos kiklos]
φελλός - [felos]
φεουδαρχία - [feudarjia]
φερμιόνιο - [fermionio]
φερορμόνη - [ferormoni]
φεστιβάλ - [festibal]
φθηνός - [fzinos]
φθινόπωρο - [fzinoporo]
φθορίωση - [fzoriosi]
φθόριο - [fzorio]
φιλανδικά - [filandika]
φιλική - [filiki]
φιλικός - [filikos]
φιλμ - [film]
φιλοδώρημα - [filodorima]
φιλολογία - [filologia]
φιλοσοφία - [filosofia]
φιλότεχνος - [filotejnos]
φινλανδικά - [finlandika]
φινλανδικός - [finlandikos]
φιστίκι - [fistiki]
φιστικιά - [fistikia]
φιόρδ - [fiord]
φλάουτο - [flauto]
φλέβα - [fleba]
φλαμανδικά - [flamandika]
φλεβίτιδα - [flebitida]
φλιτζάνι - [flitsani]
φλοιός - [flios]
φλούδα - [fluda]
φλόγα - [floga]
φοβάμαι - [fobame]
φοβία - [fobia]
φορά - [fora]
φοράδα - [forada]
φορέας δεδομένων - [foreas dedomenon]
φορητός - [foritos]
φορητός υπολογιστής - [foritos ipologistis]
φορολογία - [forologia]
φορολογικό δίκαιο - [forologiko dikeo]
φορολόγηση - [forologisi]
φορτίο θερμικών αποβλήτων - [fortio zermikon apobliton]
φορτίο λυμάτων - [fortio limaton]
φορτηγό αυτοκίνητο - [fortigo aftokinito]
φουντούκι - [fuduki]
φουράνιο - [furanio]
φουσκάλα - [fuskala]
φουσκοθαλασσιά - [fuskozalasia]
φουστάνι - [fustani]
φούρνος - [furnos]
φούρνος μικροκυμάτων - [furnos mikrokimaton]
φούστα - [fusta]
φράγμα - [fragma]
φράκτης - [fraktis]
φράουλα - [fraula]
φρέαρ - [frear]
φρέαρ υψικαμίνου - [frear ipsikaminu]
φρέον - [freon]
φρούτο - [fruto]
φρύδι - [fridi]
φρύνοι - [frini]
φτάνω - [ftano]
φτέρνα - [fterna]
φτέρωμα - [fteroma]
φτερό - [ftero]
φτηνός - [ftinos]
φτυάρι - [ftiari]
φτωχογειτονιά - [ftojogitonia]
φτωχός - [ftojos]
φτύνω - [ftino]
φτώχεια - [ftojia]
φυγοκέντριση - [figokedrisi]
φυγόκεντρος - [figokedros]
φυκοκτόνο - [fikoktono]
φυλακή - [filaki]
φυλακίζω - [filakiso]
φυλετικές σχέσεις - [filetikes sjesis]
φυλλάδιο - [filadio]
φυλλοβόλο δέντρο - [filobolo dedro]
φυλλόρροια - [filoria]
φυλοξήρα - [filoksira]
φυματίωση - [fimatiosi]
φυσαρμόνικα - [fisarmonika]
φυσικές διαδικασίες - [fisikes diadikasies]
φυσικές επιστήμες - [fisikes epistimes]
φυσικές ιδιότητες - [fisikes idiotites]
φυσική - [fisiki]
φυσική ίνα - [fisiki ina]
φυσική γεωγραφία - [fisiki geografia]
φυσική κληρονομιά - [fisiki klironomia]
φυσική μεταβολή - [fisiki metaboli]
φυσική ραδιενέργεια - [fisiki radienergia]
φυσικη ωκεανογραφία - [fisiki okeanografia]
φυσικοί πόροι - [fisiki pori]
φυσικοχημεία - [fisikojimia]
φυσικό αέριο - [fisiko aerio]
φυσικό λίπασμα - [fisiko lipasma]
φυσικό πάρκο - [fisiko parko]
φυσικό πέτρωμα - [fisiko petroma]
φυσικός δρυμός - [fisikos drimos]
φυσικός κίνδυνος - [fisikos kindinos]
φυσικός σχεδιασμός - [fisikos sjediasmos]
φυσιογνωμονική - [fisiognomoniki]
φυσιολατρία - [fisiolatria]
φυσιολογία - [fisiologia]
φυστίκι - [fistiki]
φυσώ - [fiso]
φυτικά απόβλητα - [fitika apoblita]
φυτική επιλογή - [fitiki epilogi]
φυτική κληρονομιά - [fitiki klironomia]
φυτικό έλαιο - [fitiko eleo]
φυτικό είδος - [fitiko idos]
φυτικός πληθυσμός - [fitikos plizismos]
φυτοβιολογία - [fitobiologia]
φυτοκάλυψη - [fitokalipsi]
φυτοκοινωνία - [fitokinonia]
φυτοκοινωνιολογία - [fitokinoniologia]
φυτοκομία - [fitokomia]
φυτοκομείο - [fitokomio]
φυτολογία - [fitologia]
φυτοπαθολογία - [fitopazologia]
φυτοπλαγκτόν - [fitoplagkton]
φυτοπροστασία - [fitoprostasia]
φυτοπροστατευτικό προϊόν - [fitoprostateftiko prion]
φυτοτοξικότητα - [fitotoksikotita]
φυτοφάγος - [fitofagos]
φυτοφυσιολογία - [fitofisiologia]
φυτό - [fito]
φυτώριο - [fitorio]
φυτώριο δένδρων - [fitorio dendron]
φωλεοποιό πτηνό - [foleopio ptino]
φωνή - [foni]
φωνητικό αλφάβητο - [fonitiko alfabito]
φως - [fos]
φωσφορούχο λίπασμα - [fosforujo lipasma]
φωσφόρος - [fosforos]
φωτεινός - [fotinos]
φωτεινότητα - [fotinotita]
φωτιά - [fotia]
φωτισμός - [fotismos]
φωτογραμμετρία - [fotogrametria]
φωτογραφία - [fotografia]
φωτογραφίζω - [fotografiso]
φωτογραφική - [fotografiki]
φωτορύπανση - [fotoripansi]
φωτοσύνθεση - [fotosinzesi]
φωτοτυπικό - [fototipiko]
φωτοχημική αιθαλομίχλη - [fotojimiki ezalomijli]
φωτοχημική αντίδραση - [fotojimiki adidrasi]
φωτοχημικό προϊόν - [fotojimiko prion]
φωτοχημικό φαινόμενο - [fotojimiko fenomeno]
φωτόνιο - [fotonio]
φόρος - [foros]
φόρος εισοδήματος - [foros isodimatos]
φόρος κατανάλωσης - [foros katanalosis]
φόρος καταναλώσεως - [foros katanaloseos]
φόρος κεφαλαίου - [foros kefaleu]
φύκη - [fiki]
φύλλο - [filo]
φύλλωμα - [filoma]
φύλο - [filo]
φύση - [fisi]
φύτευση - [fitefsi]
φύτρο - [fitro]
φώνημα - [fonima]
φώραση - [forasi]
χάλαζα - [jalasa]
χάλυβας - [jalibas]
χάμπουργκερ - [jaburgker]
χάμστερ - [jamster]
χάνω - [jano]
χάραξη - [jaraksi]
χάρη σε - [jari se]
χάρτα - [jarta]
χάρτης - [jartis]
χάρτης εδάφους - [jartis edafus]
χάσμα - [jasma]
χέλι - [jeli]
χέρι - [jeri]
χήνα - [jina]
χίλια - [jilia]
χίντι - [jidi]
χαιρεκακία - [jerekakia]
χαλί - [jali]
χαλίκι - [jaliki]
χαλκός - [jalkos]
χαλυβουργία - [jaliburgia]
χαμηλή πτήση - [jamili ptisi]
χαμηλή πυρκαγιά - [jamili pirkagia]
χαμηλή τεχνολογία - [jamili tejnologia]
χαμογελώ - [jamogelo]
χαμόγελο - [jamogelo]
χαμόδενδρα - [jamodendra]
χαμόδενδρο - [jamodendro]
χαμόκλαδα - [jamoklada]
χαρά - [jara]
χαράδρα - [jaradra]
χαρέμι - [jaremi]
χαρίζω - [jariso]
χαρακτήρας - [jaraktiras]
χαρακτηρισμός χρήσης γης - [jaraktirismos jrisis gis]
χαρακτηριστικό - [jaraktiristiko]
χαρτί - [jarti]
χαρτί τουαλέτας - [jarti tualetas]
χαρτί υγείας - [jarti igias]
χαρταετός - [jartaetos]
χαρτογράφηση - [jartografisi]
χαρτογράφηση λειχηνών - [jartografisi lijinon]
χαρτογραφία - [jartografia]
χαρτομάντιλο - [jartomadilo]
χαρτοπόλεμος - [jartopolemos]
χασάπης - [jasapis]
χείλος - [jilos]
χειμώνας - [jimonas]
χειραφέτηση - [jirafetisi]
χειριστής - [jiristis]
χειροκρότημα - [jirokrotima]
χειροπέδη - [jiropedi]
χειρουργικά απόβλητα - [jirurgika apoblita]
χειρουργική - [jirurgiki]
χειρόκτιο - [jiroktio]
χειρόπτερα - [jiroptera]
χειρόφρενο - [jirofreno]
χελιδόνι - [jelidoni]
χελώνια - [jelonia]
χερσαία έκταση - [jersea ektasi]
χερσαίο θηλαστικό - [jerseo zilastiko]
χηλικεραιωτά - [jilikereota]
χημεία - [jimia]
χημεία των εδαφών - [jimia ton edafon]
χημικά απόβλητα - [jimika apoblita]
χημικά στοιχεία - [jimika stijia]
χημικές αντιδράσεις - [jimikes adidrasis]
χημικές δομές - [jimikes domes]
χημικές ιδιότητες - [jimikes idiotites]
χημική ανάλυση - [jimiki analisi]
χημική αναγωγή - [jimiki anagogi]
χημική αντίδραση προσθήκης - [jimiki adidrasi proszikis]
χημική διαβρωτικότητα - [jimiki diabrotikotita]
χημική επεξεργασία - [jimiki epeksergasia]
χημική μηχανολογία - [jimiki mijanologia]
χημική ωκεανογραφία - [jimiki okeanografia]
χημικό λίπασμα - [jimiko lipasma]
χημικό σκεύασμα - [jimiko skefasma]
χημικό σύμβολο - [jimiko simbolo]
χημικό όπλο - [jimiko oplo]
χθες - [jzes]
χιλιετία - [jilietia]
χιλιετηρίδα - [jilietirida]
χιλιοστό - [jiliosto]
χιλιοστόγραμμο - [jiliostogramo]
χιλιοστόμετρο - [jiliostometro]
χιλιόμετρο - [jiliometro]
χιμπατζής - [jibatsis]
χιονίζω - [jioniso]
χιονοδρομία - [jionodromia]
χιονοδρομώ - [jionodromo]
χιονοστιβάδα - [jionostibada]
χιόνι - [jioni]
χλιμιντρίζω - [jlimidriso]
χλοοκοπτική μηχανή - [jlookoptiki mijani]
χλωρή λίπανση - [jlori lipansi]
χλωρίδα - [jlorida]
χλωρίδιο - [jloridio]
χλωρίωση - [jloriosi]
χλωραιθυλένιο - [jlorezilenio]
χλωριούχο άλας - [jloriujo alas]
χλωριωμένος υδρογονάνθρακας - [jloriomenos idrogonanzrakas]
χλωροφαινόλη - [jlorofenoli]
χλωροφθοράνθρακας - [jlorofzoranzrakas]
χλωροφύλλη - [jlorofili]
χλώριο - [jlorio]
χλώρωση - [jlorosi]
χμερ - [jmer]
χοίρος - [jiros]
χοιρινό - [jirino]
χοιρινό κρέας - [jirino kreas]
χοιροστάσιο - [jirostasio]
χολέρα - [jolera]
χολή - [joli]
χοληστερίνη - [jolisterini]
χορήγηση - [jorigisi]
χορδή - [jordi]
χορδωτά - [jordota]
χορεύω - [jorefo]
χορηγία - [jorigia]
χορτάρι - [jortari]
χορτοδοτικό φυτό - [jortodotiko fito]
χορτοκοπή - [jortokopi]
χορτονομή - [jortonomi]
χορός - [joros]
χουρμάς - [jurmas]
χουρμαδιά - [jurmadia]
χούμους - [jumus]
χούφτα - [jufta]
χρέος - [jreos]
χρήματα - [jrimata]
χρήση του εδάφους - [jrisi tu edafus]
χρήσιμος - [jrisimos]
χρεωστική κάρτα - [jreostiki karta]
χρεώνω - [jreono]
χρηματική αποζημίωση - [jrimatiki aposimiosi]
χρηματική ποινή - [jrimatiki pini]
χρηματοδότηση - [jrimatodotisi]
χρηματοπιστωτικό ταμείο - [jrimatopistotiko tamio]
χρησιμοποιημένα ορυκτέλαια - [jrisimopiimena oriktelea]
χριστιανή - [jristiani]
χριστιανικός - [jristianikos]
χριστιανός - [jristianos]
χριστουγεννιάτικο δέντρο - [jristugeniatiko dedro]
χρονικό διάστημα - [jroniko diastima]
χρονολόγηση - [jronologisi]
χρυσαλλίδα - [jrisalida]
χρυσός - [jrisos]
χρυσόφυτα - [jrisofita]
χρωματογραφία - [jromatografia]
χρωματομετρία - [jromatometria]
χρωμόσωμα - [jromosoma]
χρωστική τροφίμων - [jrostiki trofimon]
χρωστική ύλη - [jrostiki ili]
χρόνια πολλά - [jronia pola]
χρόνος - [jronos]
χρώμα - [jroma]
χρώμιο - [jromio]
χτένισμα - [jtenisma]
χτενίζω - [jteniso]
χτυπώ - [jtipo]
χυμός - [jimos]
χωματερή - [jomateri]
χωράφι - [jorafi]
χωρικά ύδατα - [jorika idata]
χωρισμός σε τεταρτημόρια - [jorismos se tetartimoria]
χωριό - [jorio]
χωρολογία - [jorologia]
χωροταξία - [jorotaksia]
χόκεϊ επί πάγου - [joki epi pagu]
χόκεϊ στον πάγο - [joki ston pago]
χόκεϋ - [jokef]
χόμπυ - [jobi]
χόριον - [jorion]
χώμα - [joma]
χώνευση - [jonefsi]
χώρος - [joros]
χώρος διαβίωσης - [joros diabiosis]
χώρος κατασκήνωσης - [joros kataskinosis]
χώρος πολιτιστικών εκδηλώσεων - [joros politistikon ekdiloseon]
χώρος πρασίνου - [joros prasinu]
χώρος στάθμευσης αυτοκινήτων - [joros stazmefsis aftokiniton]
ψάρεμα με καλάμι - [psarema me kalami]
ψάρι - [psari]
ψέμμα - [psema]
ψήνω - [psino]
ψήνω στα κάρβουνα - [psino sta karbuna]
ψήσιμο - [psisimo]
ψήφισμα - [psifisma]
ψαλίδι - [psalidi]
ψαμμίαση - [psamiasi]
ψαρεύω - [psarefo]
ψείρα - [psira]
ψεκασμένος αμίαντος - [psekasmenos amiados]
ψες - [pses]
ψευδάργυρος - [psefdargiros]
ψευδίζω - [psefdiso]
ψευδώνυμο - [psefdonimo]
ψεύδομαι - [psefdome]
ψηφιακή τεχνική gis - [psifiaki tejniki gis]
ψηφιακό μοντέλο εδάφους - [psifiako modelo edafus]
ψηφιακό σύστημα επεξεργασίας εικόνας - [psifiako sistima epeksergasias ikonas]
ψηφιδοπλέγμα - [psifidoplegma]
ψηφοφορία - [psifoforia]
ψιλά - [psila]
ψιλή ρίγα - [psili riga]
ψιψίνα - [psipsina]
ψυγείο - [psigio]
ψυκτικό έλαιο - [psiktiko eleo]
ψυκτικό ύδωρ - [psiktiko idor]
ψυχή - [psiji]
ψυχίατρος - [psijiatros]
ψυχολογία - [psijologia]
ψυχολογικός - [psijologikos]
ψυχολόγος - [psijologos]
ψυχοσωματική ασθένεια - [psijosomatiki aszenia]
ψυχοσωματικός - [psijosomatikos]
ψωμί - [psomi]
ψωνίζω - [psoniso]
ψύκτης - [psiktis]
ψύλλοι - [psili]
ψύξη - [psiksi]
ψύχος - [psijos]
ωδικό πτηνό - [odiko ptino]
ωκεάνειο ρεύμα - [okeanio refma]
ωκεάνιο κλίμα - [okeanio klima]
ωκεανογραφία - [okeanografia]
ωκεανογραφία ποταμοκόλπων - [okeanografia potamokolpon]
ωκεανός - [okeanos]
ωμ - [om]
ωμότητα - [omotita]
ωομοθετική διδικασία - [oomozetiki didikasia]
ωραία - [orea]
ωταλγία - [otalgia]
ωφέλιμος οργανισμός - [ofelimos organismos]
ωόν - [oon]
όγκος - [ogkos]
όζον - [oson]
όμβρια ύδατα - [ombria idata]
όμιλος - [omilos]
όνειρο - [oniro]
όξινη βροχή - [oksini broji]
όπλο - [oplo]
όραση - [orasi]
όργανο - [organo]
όριο ταχύτητας - [orio tajititas]
όρνεο - [orneo]
όρος - [oros]
όρος μεγάλου ύψους - [oros megalu ipsus]
όροφος - [orofos]
όρυζα - [orisa]
όρυξη - [oriksi]
όχημα - [ojima]
όχημα με κινητήρα - [ojima me kinitira]
όχημα παντός εδάφους - [ojima pados edafus]
όχθη - [ojzi]
όχι - [oji]
όχληση - [ojlisi]
όχληση λόγω οσμής - [ojlisi logo osmis]
ύαινα - [iena]
ύαλος - [ialos]
ύβωμα - [iboma]
ύδατα αποχετεύσεων - [idata apojetefseon]
ύδατα για κατανάλωση - [idata gia katanalosi]
ύδατα επεξεργασίας - [idata epeksergasias]
ύδατα κολύμβησης - [idata kolimbisis]
ύδατα πηγής - [idata pigis]
ύδατα πλημυρίδας - [idata plimiridas]
ύδρευση - [idrefsi]
ύπαιθρος - [ipezros]
ύπνος - [ipnos]
ύστερα - [istera]
ύφαλος - [ifalos]
ύφασμα - [ifasma]
ύφεση - [ifesi]
ύψος - [ipsos]
ύψος βλάστησης - [ipsos blastisis]
ύψωμα - [ipsoma]
ώμος - [omos]
ώρα - [ora]
ώσμωση - [osmosi]
ώχρα - [ojra]
ϗ - [ϗ]
зритель - [зритель]
ברמודה - [ברמודה]
מיליארדר - [מיליארדר]
ἀπὸ μηχανῆς θεός - [ἀpὸ mijanῆs zeos]
ἄκρος - [ἄkros]
ἡμικρανία - [ἡmikrania]
ἡμισφαίριον - [ἡmisferion]
ὀνειροπόληση - [ὀniropolisi]
ὠγυγία - [ὠgigia]
ὠγυγίη - [ὠgigii]
